lemma	new_para	clitics
aakkosellisesti	PCLE_NOPEASTI	opt
aakkosittain	PCLE_NOPEASTI	opt
aalloittain	PCLE_NOPEASTI	opt
aasimaisesti	PCLE_NOPEASTI	opt
aatteellisesti	PCLE_NOPEASTI	opt
aavemaisesti	PCLE_NOPEASTI	opt
absoluuttisesti	PCLE_NOPEASTI	opt
abstraktisesti	PCLE_NOPEASTI	opt
abstraktisti	PCLE_NOPEASTI	opt
absurdisti	PCLE_NOPEASTI	opt
adekvaatisti	PCLE_NOPEASTI	opt
adjektiivisesti	PCLE_NOPEASTI	opt
adverbiaalisesti	PCLE_NOPEASTI	opt
adverbisesti	PCLE_NOPEASTI	opt
adversatiivisesti	PCLE_NOPEASTI	opt
aerodynaamisesti	PCLE_NOPEASTI	opt
affektiivisesti	PCLE_NOPEASTI	opt
affektisesti	PCLE_NOPEASTI	opt
aggressiivisesti	PCLE_NOPEASTI	opt
agnostisesti	PCLE_NOPEASTI	opt
ahdashenkisesti	PCLE_TYHMÄSTI	opt
ahdasmielisesti	PCLE_TYHMÄSTI	opt
ahdasnäköisesti	PCLE_TYHMÄSTI	opt
ahdasrajaisesti	PCLE_NOPEASTI	opt
ahdistuneesti	PCLE_NOPEASTI	opt
ahkerasti	PCLE_NOPEASTI	opt
ahnaasti	PCLE_NOPEASTI	opt
ahneesti	PCLE_NOPEASTI	opt
ahtaasti	PCLE_NOPEASTI	opt
aidosti	PCLE_NOPEASTI	opt
aiheellisesti	PCLE_NOPEASTI	opt
aiheettomasti	PCLE_NOPEASTI	opt
aikaan	PCLE_VALTAAN	opt
aina	PCLE_KOTONA	opt
aistikkaasti	PCLE_NOPEASTI	opt
aistillisesti	PCLE_NOPEASTI	opt
ajallisesti	PCLE_NOPEASTI	opt
ajanmukaisesti	PCLE_NOPEASTI	opt
ajattelemattomasti	PCLE_NOPEASTI	opt
ajattomasti	PCLE_NOPEASTI	opt
ajatuksellisesti	PCLE_NOPEASTI	opt
ajatuksettomasti	PCLE_NOPEASTI	opt
ajoittain	PCLE_NOPEASTI	opt
akateemisesti	PCLE_NOPEASTI	opt
akkamaisesti	PCLE_NOPEASTI	opt
aksiaalisesti	PCLE_NOPEASTI	opt
aksiomaattisesti	PCLE_NOPEASTI	opt
aktiivisesti	PCLE_NOPEASTI	opt
aktuaalisesti	PCLE_NOPEASTI	opt
akustisesti	PCLE_NOPEASTI	opt
akuutisti	PCLE_NOPEASTI	opt
ala-arvoisesti	PCLE_NOPEASTI	opt
alakanttiin	PCLE_VALTAAN	opt
alakuloisesti	PCLE_NOPEASTI	opt
alamaisesti	PCLE_NOPEASTI	opt
alasti	PCLE_NOPEASTI	opt
alentavasti	PCLE_NOPEASTI	opt
alentuvaisesti	PCLE_NOPEASTI	opt
alentuvasti	PCLE_NOPEASTI	opt
alhaisesti	PCLE_NOPEASTI	opt
alituisesti	PCLE_NOPEASTI	opt
alkeellisesti	PCLE_NOPEASTI	opt
alkukantaisesti	PCLE_NOPEASTI	opt
alkuperäisesti	PCLE_TYHMÄSTI	opt
allegorisesti	PCLE_NOPEASTI	opt
aloittain	PCLE_NOPEASTI	opt
altruistisesti	PCLE_NOPEASTI	opt
alttiisti	PCLE_NOPEASTI	opt
alueellisesti	PCLE_NOPEASTI	opt
alueittain	PCLE_NOPEASTI	opt
alustavasti	PCLE_NOPEASTI	opt
ammateittain	PCLE_NOPEASTI	opt
ammatillisesti	PCLE_NOPEASTI	opt
ammattimaisesti	PCLE_NOPEASTI	opt
anakronistisesti	PCLE_NOPEASTI	opt
analgeettisesti	PCLE_NOPEASTI	opt
analogisesti	PCLE_NOPEASTI	opt
analyyttisesti	PCLE_TYHMÄSTI	opt
anarkistisesti	PCLE_NOPEASTI	opt
anatomisesti	PCLE_NOPEASTI	opt
andrologisesti	PCLE_NOPEASTI	opt
aneemisesti	PCLE_NOPEASTI	opt
anestesiologisesti	PCLE_NOPEASTI	opt
ankarasti	PCLE_NOPEASTI	opt
ankeasti	PCLE_NOPEASTI	opt
annoksittain	PCLE_NOPEASTI	opt
anomaalisesti	PCLE_NOPEASTI	opt
ansaitusti	PCLE_NOPEASTI	opt
ansiokkaasti	PCLE_NOPEASTI	opt
ansiottomasti	PCLE_NOPEASTI	opt
antaumuksellisesti	PCLE_NOPEASTI	opt
anteeksiantamattomasti	PCLE_NOPEASTI	opt
anteliaasti	PCLE_NOPEASTI	opt
antisemiittisesti	PCLE_TYHMÄSTI	opt
antoisasti	PCLE_NOPEASTI	opt
antropologisesti	PCLE_NOPEASTI	opt
apaattisesti	PCLE_NOPEASTI	opt
apeasti	PCLE_NOPEASTI	opt
apokryfisesti	PCLE_TYHMÄSTI	opt
apriorisesti	PCLE_NOPEASTI	opt
arasti	PCLE_NOPEASTI	opt
aristokraattisesti	PCLE_NOPEASTI	opt
arkaistisesti	PCLE_NOPEASTI	opt
arkeittain	PCLE_NOPEASTI	opt
arkeologisesti	PCLE_NOPEASTI	opt
arkisesti	PCLE_NOPEASTI	opt
arkittain	PCLE_NOPEASTI	opt
arkkitehtonisesti	PCLE_NOPEASTI	opt
armeliaasti	PCLE_NOPEASTI	opt
armollisesti	PCLE_NOPEASTI	opt
armottomasti	PCLE_NOPEASTI	opt
arrogantisti	PCLE_NOPEASTI	opt
arvaamattomasti	PCLE_NOPEASTI	opt
arvattavasti	PCLE_NOPEASTI	opt
arvelevasti	PCLE_NOPEASTI	opt
arveluttavasti	PCLE_NOPEASTI	opt
arvoituksellisesti	PCLE_NOPEASTI	opt
arvokkaasti	PCLE_NOPEASTI	opt
arvostelevasti	PCLE_NOPEASTI	opt
arvostelukyvyttömästi	PCLE_TYHMÄSTI	opt
arvottomasti	PCLE_NOPEASTI	opt
arvovaltaisesti	PCLE_NOPEASTI	opt
arvoväritteisesti	PCLE_TYHMÄSTI	opt
asenteellisesti	PCLE_NOPEASTI	opt
aseptisesti	PCLE_NOPEASTI	opt
asiallisesti	PCLE_NOPEASTI	opt
asianmukaisesti	PCLE_NOPEASTI	opt
asiantuntevasti	PCLE_NOPEASTI	opt
asiattomasti	PCLE_NOPEASTI	opt
askeettisesti	PCLE_NOPEASTI	opt
askelittain	PCLE_NOPEASTI	opt
askelmittain	PCLE_NOPEASTI	opt
asosiaalisesti	PCLE_NOPEASTI	opt
asteittain	PCLE_NOPEASTI	opt
asti	PCLE_NOPEASTI	opt
astioittain	PCLE_NOPEASTI	opt
astrologisesti	PCLE_NOPEASTI	opt
astronomisesti	PCLE_NOPEASTI	opt
asymmetrisesti	PCLE_TYHMÄSTI	opt
atavistisesti	PCLE_NOPEASTI	opt
ateistisesti	PCLE_NOPEASTI	opt
attraktiivisesti	PCLE_NOPEASTI	opt
auktoritatiivisesti	PCLE_NOPEASTI	opt
auliisti	PCLE_NOPEASTI	opt
aurinkoisesti	PCLE_NOPEASTI	opt
automaattisesti	PCLE_NOPEASTI	opt
autoritaarisesti	PCLE_NOPEASTI	opt
autoritäärisesti	PCLE_TYHMÄSTI	opt
auttamattomasti	PCLE_NOPEASTI	opt
auttavasti	PCLE_NOPEASTI	opt
autuaallisesti	PCLE_NOPEASTI	opt
autuaasti	PCLE_NOPEASTI	opt
avarakatseisesti	PCLE_NOPEASTI	opt
avaramielisesti	PCLE_TYHMÄSTI	opt
avoimesti	PCLE_NOPEASTI	opt
avokatseisesti	PCLE_NOPEASTI	opt
avokätisesti	PCLE_TYHMÄSTI	opt
avomielisesti	PCLE_NOPEASTI	opt
avonaisesti	PCLE_NOPEASTI	opt
avosydämisesti	PCLE_TYHMÄSTI	opt
avuliaasti	PCLE_NOPEASTI	opt
avuttomasti	PCLE_NOPEASTI	opt
bakteriologisesti	PCLE_NOPEASTI	opt
banaalisti	PCLE_NOPEASTI	opt
barbaarimaisesti	PCLE_NOPEASTI	opt
barbaarisesti	PCLE_NOPEASTI	opt
bilateraalisesti	PCLE_NOPEASTI	opt
biodynaamisesti	PCLE_NOPEASTI	opt
biokemiallisesti	PCLE_NOPEASTI	opt
biologisesti	PCLE_NOPEASTI	opt
bioteknisesti	PCLE_TYHMÄSTI	opt
bisarristi	PCLE_NOPEASTI	opt
biseksuaalisesti	PCLE_NOPEASTI	opt
botaanisesti	PCLE_NOPEASTI	opt
brežneviläisesti	PCLE_TYHMÄSTI	opt
byrokraattisesti	PCLE_NOPEASTI	opt
deduktiivisesti	PCLE_NOPEASTI	opt
defensiivisesti	PCLE_TYHMÄSTI	opt
definiittisesti	PCLE_TYHMÄSTI	opt
definitiivisesti	PCLE_TYHMÄSTI	opt
dekadentisti	PCLE_NOPEASTI	opt
dekoratiivisesti	PCLE_NOPEASTI	opt
demagogisesti	PCLE_NOPEASTI	opt
demografisesti	PCLE_NOPEASTI	opt
demokraattisesti	PCLE_NOPEASTI	opt
demonisesti	PCLE_NOPEASTI	opt
demonstratiivisesti	PCLE_NOPEASTI	opt
depressiivisesti	PCLE_TYHMÄSTI	opt
dermatologisesti	PCLE_NOPEASTI	opt
deskriptiivisesti	PCLE_TYHMÄSTI	opt
despoottisesti	PCLE_NOPEASTI	opt
deterministisesti	PCLE_TYHMÄSTI	opt
diagnostisesti	PCLE_NOPEASTI	opt
dialektisesti	PCLE_NOPEASTI	opt
didaktisesti	PCLE_NOPEASTI	opt
digitaalisesti	PCLE_NOPEASTI	opt
diktatorisesti	PCLE_NOPEASTI	opt
dogmaattisesti	PCLE_NOPEASTI	opt
dominantisti	PCLE_NOPEASTI	opt
dorkasti	PCLE_NOPEASTI	opt
draamallisesti	PCLE_NOPEASTI	opt
dramaattisesti	PCLE_NOPEASTI	opt
drastisesti	PCLE_NOPEASTI	opt
dualistisesti	PCLE_NOPEASTI	opt
dynaamisesti	PCLE_NOPEASTI	opt
edesvastuuttomasti	PCLE_NOPEASTI	opt
edistyksellisesti	PCLE_TYHMÄSTI	opt
edullisesti	PCLE_NOPEASTI	opt
edustavasti	PCLE_NOPEASTI	opt
eettisesti	PCLE_TYHMÄSTI	opt
efektiivisesti	PCLE_TYHMÄSTI	opt
egoistisesti	PCLE_NOPEASTI	opt
egosentrisesti	PCLE_TYHMÄSTI	opt
ehdollisesti	PCLE_NOPEASTI	opt
ehdottomasti	PCLE_NOPEASTI	opt
eheästi	PCLE_TYHMÄSTI	opt
ehjästi	PCLE_TYHMÄSTI	opt
-ehtoisesti	PCLE_NOPEASTI	opt
ei-leksikaalisesti	PCLE_NOPEASTI	opt
ekologisesti	PCLE_NOPEASTI	opt
ekonometrisesti	PCLE_NOPEASTI	opt
ekonomisesti	PCLE_NOPEASTI	opt
eksaktisti	PCLE_NOPEASTI	opt
eksentrisesti	PCLE_TYHMÄSTI	opt
eksoottisesti	PCLE_NOPEASTI	opt
ekspansiivisesti	PCLE_NOPEASTI	opt
eksplisiittisesti	PCLE_TYHMÄSTI	opt
eksponentiaalisesti	PCLE_NOPEASTI	opt
ekspressiivisesti	PCLE_TYHMÄSTI	opt
ekstaattisesti	PCLE_NOPEASTI	opt
ekumeenisesti	PCLE_NOPEASTI	opt
elastisesti	PCLE_NOPEASTI	opt
eleettömästi	PCLE_TYHMÄSTI	opt
elegantisti	PCLE_NOPEASTI	opt
elegisesti	PCLE_TYHMÄSTI	opt
-eleisesti	PCLE_TYHMÄSTI	opt
elektrolyyttisesti	PCLE_TYHMÄSTI	opt
elektronisesti	PCLE_NOPEASTI	opt
elementaarisesti	PCLE_NOPEASTI	opt
elimellisesti	PCLE_TYHMÄSTI	opt
eloisasti	PCLE_NOPEASTI	opt
elottomasti	PCLE_NOPEASTI	opt
eläimellisesti	PCLE_TYHMÄSTI	opt
elämyksellisesti	PCLE_TYHMÄSTI	opt
elämänkatsomuksellisesti	PCLE_NOPEASTI	opt
elämänkielteisesti	PCLE_TYHMÄSTI	opt
elämänläheisesti	PCLE_TYHMÄSTI	opt
elämänmyönteisesti	PCLE_TYHMÄSTI	opt
elävästi	PCLE_TYHMÄSTI	opt
embryologisesti	PCLE_NOPEASTI	opt
emotionaalisesti	PCLE_NOPEASTI	opt
empaattisesti	PCLE_NOPEASTI	opt
empiirisesti	PCLE_TYHMÄSTI	opt
emäksisesti	PCLE_TYHMÄSTI	opt
endeemisesti	PCLE_TYHMÄSTI	opt
endokrinologisesti	PCLE_NOPEASTI	opt
enenevästi	PCLE_TYHMÄSTI	opt
energisesti	PCLE_TYHMÄSTI	opt
ennakkoluuloisesti	PCLE_NOPEASTI	opt
ennakkoluulottomasti	PCLE_NOPEASTI	opt
ennen	PCLE_TYHMÄSTI	opt
ennenaikaisesti	PCLE_NOPEASTI	opt
ennenkuulumattomasti	PCLE_NOPEASTI	opt
ennennäkemättömästi	PCLE_TYHMÄSTI	opt
ennätyksellisesti	PCLE_TYHMÄSTI	opt
ennätysmäisesti	PCLE_TYHMÄSTI	opt
ensiluokkaisesti	PCLE_NOPEASTI	opt
ensin	PCLE_NÄKYVIIN	opt
ensisijaisesti	PCLE_NOPEASTI	opt
enteellisesti	PCLE_TYHMÄSTI	opt
epidemiologisesti	PCLE_NOPEASTI	opt
epäaidosti	PCLE_NOPEASTI	opt
epäasiallisesti	PCLE_NOPEASTI	opt
epädemokraattisesti	PCLE_NOPEASTI	opt
epäedullisesti	PCLE_NOPEASTI	opt
epäesteettisesti	PCLE_TYHMÄSTI	opt
epähavainnollisesti	PCLE_NOPEASTI	opt
epähienosti	PCLE_NOPEASTI	opt
epähistoriallisesti	PCLE_NOPEASTI	opt
epähygieenisesti	PCLE_TYHMÄSTI	opt
epäilevästi	PCLE_TYHMÄSTI	opt
epäilyttävästi	PCLE_TYHMÄSTI	opt
epäinhimillisesti	PCLE_TYHMÄSTI	opt
epäitsekkäästi	PCLE_TYHMÄSTI	opt
epäitsenäisesti	PCLE_TYHMÄSTI	opt
epäjohdonmukaisesti	PCLE_NOPEASTI	opt
epäjumalallisesti	PCLE_NOPEASTI	opt
epäkeskisesti	PCLE_TYHMÄSTI	opt
epäkiitollisesti	PCLE_NOPEASTI	opt
epäkohteliaasti	PCLE_NOPEASTI	opt
epäkriittisesti	PCLE_TYHMÄSTI	opt
epäkristillisesti	PCLE_TYHMÄSTI	opt
epäkunnioittavasti	PCLE_NOPEASTI	opt
epäkypsästi	PCLE_TYHMÄSTI	opt
epäkäytännöllisesti	PCLE_TYHMÄSTI	opt
epälojaalisesti	PCLE_NOPEASTI	opt
epälojaalisti	PCLE_NOPEASTI	opt
epäloogisesti	PCLE_NOPEASTI	opt
epäluonnollisesti	PCLE_NOPEASTI	opt
epäluotettavasti	PCLE_NOPEASTI	opt
epäluuloisesti	PCLE_NOPEASTI	opt
epämiehekkäästi	PCLE_TYHMÄSTI	opt
epämiellyttävästi	PCLE_TYHMÄSTI	opt
epämieluisasti	PCLE_NOPEASTI	opt
epämukavasti	PCLE_NOPEASTI	opt
epämuodollisesti	PCLE_NOPEASTI	opt
epämusikaalisesti	PCLE_NOPEASTI	opt
epämääräisesti	PCLE_TYHMÄSTI	opt
epänaisellisesti	PCLE_NOPEASTI	opt
epänormaalisti	PCLE_NOPEASTI	opt
epäoikeudenmukaisesti	PCLE_NOPEASTI	opt
epäolennaisesti	PCLE_NOPEASTI	opt
epäortodoksisesti	PCLE_NOPEASTI	opt
epäparlamentaarisesti	PCLE_NOPEASTI	opt
epäpoliittisesti	PCLE_NOPEASTI	opt
epäpuhtaasti	PCLE_NOPEASTI	opt
epäpätevästi	PCLE_TYHMÄSTI	opt
epärealistisesti	PCLE_NOPEASTI	opt
epärehellisesti	PCLE_TYHMÄSTI	opt
epäreilusti	PCLE_NOPEASTI	opt
epäselvästi	PCLE_TYHMÄSTI	opt
epäsiististi	PCLE_TYHMÄSTI	opt
epäsiveellisesti	PCLE_TYHMÄSTI	opt
epäsointuisesti	PCLE_NOPEASTI	opt
epäsopuisesti	PCLE_NOPEASTI	opt
epäsosiaalisesti	PCLE_NOPEASTI	opt
epäsovinnaisesti	PCLE_NOPEASTI	opt
epäsuhtaisesti	PCLE_NOPEASTI	opt
epäsuomalaisesti	PCLE_NOPEASTI	opt
epäsuopeasti	PCLE_NOPEASTI	opt
epäsuorasti	PCLE_NOPEASTI	opt
epäsuosiollisesti	PCLE_NOPEASTI	opt
epäsuotuisasti	PCLE_NOPEASTI	opt
epäsymmetrisesti	PCLE_TYHMÄSTI	opt
epäsäännöllisesti	PCLE_TYHMÄSTI	opt
epätaiteellisesti	PCLE_NOPEASTI	opt
epätaloudellisesti	PCLE_NOPEASTI	opt
epätarkasti	PCLE_NOPEASTI	opt
epätarkoituksenmukaisesti	PCLE_NOPEASTI	opt
epätasaisesti	PCLE_NOPEASTI	opt
epätavallisesti	PCLE_NOPEASTI	opt
epäterveellisesti	PCLE_TYHMÄSTI	opt
epäterveesti	PCLE_TYHMÄSTI	opt
epätieteellisesti	PCLE_TYHMÄSTI	opt
epätodennäköisesti	PCLE_TYHMÄSTI	opt
epätoivoisesti	PCLE_NOPEASTI	opt
epätyydyttävästi	PCLE_TYHMÄSTI	opt
epätäsmällisesti	PCLE_TYHMÄSTI	opt
epätäydellisesti	PCLE_TYHMÄSTI	opt
epäurheilijamaisesti	PCLE_NOPEASTI	opt
epäuskoisesti	PCLE_NOPEASTI	opt
epäuskottavasti	PCLE_NOPEASTI	opt
epävakaasti	PCLE_NOPEASTI	opt
epävakaisesti	PCLE_NOPEASTI	opt
epävarmasti	PCLE_NOPEASTI	opt
epäviihtyisästi	PCLE_TYHMÄSTI	opt
epäviisaasti	PCLE_NOPEASTI	opt
epävirallisesti	PCLE_NOPEASTI	opt
epävireisesti	PCLE_TYHMÄSTI	opt
epäyhtenäisesti	PCLE_TYHMÄSTI	opt
epäystävällisesti	PCLE_TYHMÄSTI	opt
epäämättömästi	PCLE_TYHMÄSTI	opt
ergonomisesti	PCLE_NOPEASTI	opt
erheellisesti	PCLE_TYHMÄSTI	opt
eriaikaisesti	PCLE_NOPEASTI	opt
eriasteisesti	PCLE_NOPEASTI	opt
erikoisesti	PCLE_NOPEASTI	opt
erikoislaatuisesti	PCLE_NOPEASTI	opt
erimielisesti	PCLE_TYHMÄSTI	opt
erimuotoisesti	PCLE_NOPEASTI	opt
erinomaisesti	PCLE_NOPEASTI	opt
eripuraisesti	PCLE_NOPEASTI	opt
eriskummallisesti	PCLE_NOPEASTI	opt
erisuuntaisesti	PCLE_NOPEASTI	opt
eritasoisesti	PCLE_NOPEASTI	opt
erittäin	PCLE_TYHMÄSTI	opt
erityisen	PCLE_NÄKYVIIN	opt
erityisesti	PCLE_TYHMÄSTI	opt
erityyppisesti	PCLE_TYHMÄSTI	opt
eriyttävästi	PCLE_TYHMÄSTI	opt
eroottisesti	PCLE_NOPEASTI	opt
erottamattomasti	PCLE_NOPEASTI	opt
esikuvallisesti	PCLE_NOPEASTI	opt
esimerkillisesti	PCLE_TYHMÄSTI	opt
esteettisesti	PCLE_TYHMÄSTI	opt
estottomasti	PCLE_NOPEASTI	opt
eteerisesti	PCLE_TYHMÄSTI	opt
etevästi	PCLE_TYHMÄSTI	opt
etiologisesti	PCLE_NOPEASTI	opt
etnisesti	PCLE_TYHMÄSTI	opt
etnografisesti	PCLE_NOPEASTI	opt
etnologisesti	PCLE_NOPEASTI	opt
etupainotteisesti	PCLE_NOPEASTI	opt
etymologisesti	PCLE_NOPEASTI	opt
etäisesti	PCLE_TYHMÄSTI	opt
eufemistisesti	PCLE_NOPEASTI	opt
euforisesti	PCLE_NOPEASTI	opt
faktisesti	PCLE_NOPEASTI	opt
fakultatiivisesti	PCLE_NOPEASTI	opt
falskisti	PCLE_NOPEASTI	opt
fanaattisesti	PCLE_NOPEASTI	opt
fantastisesti	PCLE_NOPEASTI	opt
farmakologisesti	PCLE_NOPEASTI	opt
fataalisesti	PCLE_NOPEASTI	opt
fataalisti	PCLE_NOPEASTI	opt
fatalistisesti	PCLE_NOPEASTI	opt
feminiinisesti	PCLE_TYHMÄSTI	opt
feministisesti	PCLE_TYHMÄSTI	opt
fennistisesti	PCLE_TYHMÄSTI	opt
fenomenaalisesti	PCLE_NOPEASTI	opt
fenomenologisesti	PCLE_NOPEASTI	opt
feodaalisesti	PCLE_NOPEASTI	opt
feodalistisesti	PCLE_NOPEASTI	opt
figuratiivisesti	PCLE_NOPEASTI	opt
fiksusti	PCLE_NOPEASTI	opt
fiktiivisesti	PCLE_TYHMÄSTI	opt
filantrooppisesti	PCLE_NOPEASTI	opt
filmaattisesti	PCLE_NOPEASTI	opt
filologisesti	PCLE_NOPEASTI	opt
filosofisesti	PCLE_NOPEASTI	opt
finaalisesti	PCLE_NOPEASTI	opt
flegmaattisesti	PCLE_NOPEASTI	opt
foneettisesti	PCLE_NOPEASTI	opt
foniatrisesti	PCLE_NOPEASTI	opt
fonologisesti	PCLE_NOPEASTI	opt
formaalisesti	PCLE_NOPEASTI	opt
formaalisti	PCLE_NOPEASTI	opt
formalistisesti	PCLE_NOPEASTI	opt
fragmentaarisesti	PCLE_NOPEASTI	opt
frontaalisesti	PCLE_NOPEASTI	opt
fundamentaalisesti	PCLE_NOPEASTI	opt
fundamentalistisesti	PCLE_NOPEASTI	opt
funktionaalisesti	PCLE_NOPEASTI	opt
funktionalistisesti	PCLE_NOPEASTI	opt
futurologisesti	PCLE_NOPEASTI	opt
fylogeneettisesti	PCLE_NOPEASTI	opt
fysiatrisesti	PCLE_NOPEASTI	opt
fysikaalisesti	PCLE_NOPEASTI	opt
fysiologisesti	PCLE_NOPEASTI	opt
fyysisesti	PCLE_TYHMÄSTI	opt
galvaanisesti	PCLE_NOPEASTI	opt
gastronomisesti	PCLE_NOPEASTI	opt
gemmologisesti	PCLE_NOPEASTI	opt
geneettisesti	PCLE_TYHMÄSTI	opt
geodeettisesti	PCLE_NOPEASTI	opt
geofysikaalisesti	PCLE_NOPEASTI	opt
geologisesti	PCLE_NOPEASTI	opt
geometrisesti	PCLE_NOPEASTI	opt
geomorfologisesti	PCLE_NOPEASTI	opt
geopoliittisesti	PCLE_NOPEASTI	opt
geriatrisesti	PCLE_NOPEASTI	opt
giganttisesti	PCLE_NOPEASTI	opt
globaalisesti	PCLE_NOPEASTI	opt
globaalisti	PCLE_NOPEASTI	opt
gnostisistisesti	PCLE_NOPEASTI	opt
graafisesti	PCLE_NOPEASTI	opt
grafologisesti	PCLE_NOPEASTI	opt
grammaattisesti	PCLE_NOPEASTI	opt
haaveellisesti	PCLE_NOPEASTI	opt
haikeasti	PCLE_NOPEASTI	opt
haitallisesti	PCLE_NOPEASTI	opt
haitattomasti	PCLE_NOPEASTI	opt
hajamielisesti	PCLE_TYHMÄSTI	opt
hajanaisesti	PCLE_NOPEASTI	opt
hajuttomasti	PCLE_NOPEASTI	opt
-hakuisesti	PCLE_NOPEASTI	opt
hallinnollisesti	PCLE_NOPEASTI	opt
hallitusti	PCLE_NOPEASTI	opt
halpamaisesti	PCLE_NOPEASTI	opt
halukkaasti	PCLE_NOPEASTI	opt
haluttomasti	PCLE_NOPEASTI	opt
halventavasti	PCLE_NOPEASTI	opt
hampaattomasti	PCLE_NOPEASTI	opt
hanakasti	PCLE_NOPEASTI	opt
hanttiin	PCLE_VALTAAN	opt
happamasti	PCLE_NOPEASTI	opt
happamesti	PCLE_NOPEASTI	opt
harkitsemattomasti	PCLE_NOPEASTI	opt
harkitusti	PCLE_NOPEASTI	opt
hartaasti	PCLE_NOPEASTI	opt
hassusti	PCLE_NOPEASTI	opt
hatarasti	PCLE_NOPEASTI	opt
haudanvakavasti	PCLE_NOPEASTI	opt
hauskasti	PCLE_NOPEASTI	opt
havainnollisesti	PCLE_NOPEASTI	opt
havaittavasti	PCLE_NOPEASTI	opt
hedelmällisesti	PCLE_TYHMÄSTI	opt
heikosti	PCLE_NOPEASTI	opt
hektisesti	PCLE_TYHMÄSTI	opt
hekumallisesti	PCLE_NOPEASTI	opt
helakasti	PCLE_NOPEASTI	opt
heleästi	PCLE_TYHMÄSTI	opt
helkkaristi	PCLE_NOPEASTI	opt
hellittämättömästi	PCLE_TYHMÄSTI	opt
helläkätisesti	PCLE_TYHMÄSTI	opt
hellästi	PCLE_TYHMÄSTI	opt
hellävaraisesti	PCLE_NOPEASTI	opt
helposti	PCLE_NOPEASTI	opt
helpottuneesti	PCLE_NOPEASTI	opt
helppotajuisesti	PCLE_NOPEASTI	opt
helteisesti	PCLE_TYHMÄSTI	opt
helvetisti	PCLE_TYHMÄSTI	opt
hemaisevasti	PCLE_NOPEASTI	opt
hemmetisti	PCLE_TYHMÄSTI	opt
hempeästi	PCLE_TYHMÄSTI	opt
hengenvaarallisesti	PCLE_NOPEASTI	opt
hengettömästi	PCLE_TYHMÄSTI	opt
henkevästi	PCLE_TYHMÄSTI	opt
henkilökohtaisesti	PCLE_NOPEASTI	opt
henkisesti	PCLE_TYHMÄSTI	opt
heppoisesti	PCLE_NOPEASTI	opt
hereästi	PCLE_TYHMÄSTI	opt
herkeämättömästi	PCLE_TYHMÄSTI	opt
herkullisesti	PCLE_NOPEASTI	opt
herkästi	PCLE_TYHMÄSTI	opt
hermeettisesti	PCLE_TYHMÄSTI	opt
hermostuneesti	PCLE_NOPEASTI	opt
herraskaisesti	PCLE_NOPEASTI	opt
herttaisesti	PCLE_NOPEASTI	opt
hervottomasti	PCLE_NOPEASTI	opt
hetkellisesti	PCLE_TYHMÄSTI	opt
hetkittäin	PCLE_TYHMÄSTI	opt
hevoskuormittain	PCLE_NOPEASTI	opt
hienoisesti	PCLE_NOPEASTI	opt
hienosti	PCLE_NOPEASTI	opt
hienostuneesti	PCLE_NOPEASTI	opt
hienotunteisesti	PCLE_NOPEASTI	opt
hienovaraisesti	PCLE_NOPEASTI	opt
hiipivästi	PCLE_TYHMÄSTI	opt
hiivatisti	PCLE_NOPEASTI	opt
hiljaisesti	PCLE_NOPEASTI	opt
hiljattain	PCLE_NOPEASTI	opt
hillittömästi	PCLE_TYHMÄSTI	opt
hillitysti	PCLE_TYHMÄSTI	opt
hilpeästi	PCLE_TYHMÄSTI	opt
himmeästi	PCLE_TYHMÄSTI	opt
himokkaasti	PCLE_NOPEASTI	opt
hirmuisesti	PCLE_NOPEASTI	opt
hirveästi	PCLE_TYHMÄSTI	opt
hirvittävästi	PCLE_TYHMÄSTI	opt
hitaasti	PCLE_NOPEASTI	opt
hitosti	PCLE_NOPEASTI	opt
hiuksenhienosti	PCLE_NOPEASTI	opt
hohdokkaasti	PCLE_NOPEASTI	opt
holtittomasti	PCLE_NOPEASTI	opt
huikeasti	PCLE_NOPEASTI	opt
huikentelevaisesti	PCLE_NOPEASTI	opt
huikentelevasti	PCLE_NOPEASTI	opt
huimaavasti	PCLE_NOPEASTI	opt
huimapäisesti	PCLE_TYHMÄSTI	opt
huimasti	PCLE_NOPEASTI	opt
hullunkurisesti	PCLE_NOPEASTI	opt
hullusti	PCLE_NOPEASTI	opt
humoristisesti	PCLE_NOPEASTI	opt
hunajaisesti	PCLE_NOPEASTI	opt
huolehtivaisesti	PCLE_NOPEASTI	opt
huolellisesti	PCLE_NOPEASTI	opt
huolettomasti	PCLE_NOPEASTI	opt
huolimattomasti	PCLE_NOPEASTI	opt
huomaamattomasti	PCLE_NOPEASTI	opt
huomaavaisesti	PCLE_NOPEASTI	opt
huomattavasti	PCLE_NOPEASTI	opt
huonosti	PCLE_NOPEASTI	opt
hupaisasti	PCLE_NOPEASTI	opt
hupsusti	PCLE_NOPEASTI	opt
hurjasti	PCLE_NOPEASTI	opt
hurmaavasti	PCLE_NOPEASTI	opt
hurskaasti	PCLE_NOPEASTI	opt
huumorintajuisesti	PCLE_NOPEASTI	opt
hydraulisesti	PCLE_NOPEASTI	opt
hygieenisesti	PCLE_TYHMÄSTI	opt
hyisesti	PCLE_TYHMÄSTI	opt
hypnoottisesti	PCLE_NOPEASTI	opt
hyppäyksittäin	PCLE_TYHMÄSTI	opt
hysteerisesti	PCLE_TYHMÄSTI	opt
hyveellisesti	PCLE_TYHMÄSTI	opt
hyväksyttävästi	PCLE_TYHMÄSTI	opt
hyvänsuovasti	PCLE_NOPEASTI	opt
hyväntahtoisesti	PCLE_NOPEASTI	opt
hyväntuulisesti	PCLE_NOPEASTI	opt
hyvästi	PCLE_TYHMÄSTI	opt
hyväsydämisesti	PCLE_TYHMÄSTI	opt
hyväuskoisesti	PCLE_NOPEASTI	opt
hyödyllisesti	PCLE_TYHMÄSTI	opt
hyödyttömästi	PCLE_TYHMÄSTI	opt
hyökkäävästi	PCLE_TYHMÄSTI	opt
häijysti	PCLE_TYHMÄSTI	opt
häikäilemättömästi	PCLE_TYHMÄSTI	opt
hälyttävästi	PCLE_TYHMÄSTI	opt
hämäläisittäin	PCLE_TYHMÄSTI	opt
hämärästi	PCLE_TYHMÄSTI	opt
häpeällisesti	PCLE_TYHMÄSTI	opt
häpeämättömästi	PCLE_TYHMÄSTI	opt
härkäpäisesti	PCLE_TYHMÄSTI	opt
härskisti	PCLE_TYHMÄSTI	opt
hätäisesti	PCLE_TYHMÄSTI	opt
häveliäästi	PCLE_TYHMÄSTI	opt
hävyttömästi	PCLE_TYHMÄSTI	opt
häävisti	PCLE_TYHMÄSTI	opt
hölläkätisesti	PCLE_TYHMÄSTI	opt
höllästi	PCLE_TYHMÄSTI	opt
hölmösti	PCLE_TYHMÄSTI	opt
höperösti	PCLE_TYHMÄSTI	opt
hövelisti	PCLE_TYHMÄSTI	opt
höylisti	PCLE_TYHMÄSTI	opt
iankaikkisesti	PCLE_NOPEASTI	opt
identtisesti	PCLE_TYHMÄSTI	opt
idioottimaisesti	PCLE_NOPEASTI	opt
idyllisesti	PCLE_TYHMÄSTI	opt
ihailevasti	PCLE_NOPEASTI	opt
ihailtavasti	PCLE_NOPEASTI	opt
ihanasti	PCLE_NOPEASTI	opt
ihanteellisesti	PCLE_NOPEASTI	opt
ihastuttavasti	PCLE_NOPEASTI	opt
ihmeellisesti	PCLE_TYHMÄSTI	opt
ihmeesti	PCLE_TYHMÄSTI	opt
ihmeteltävästi	PCLE_TYHMÄSTI	opt
ihmisläheisesti	PCLE_TYHMÄSTI	opt
ihmismäisesti	PCLE_TYHMÄSTI	opt
iisisti	PCLE_TYHMÄSTI	opt
ikuisesti	PCLE_NOPEASTI	opt
ikävystyneesti	PCLE_TYHMÄSTI	opt
ikävystyttävästi	PCLE_TYHMÄSTI	opt
ikävästi	PCLE_TYHMÄSTI	opt
iljettävästi	PCLE_TYHMÄSTI	opt
ilkeästi	PCLE_TYHMÄSTI	opt
ilkialasti	PCLE_NOPEASTI	opt
ilkikurisesti	PCLE_NOPEASTI	opt
ilkivaltaisesti	PCLE_NOPEASTI	opt
ilmanpitävästi	PCLE_TYHMÄSTI	opt
ilmastollisesti	PCLE_NOPEASTI	opt
ilmatiiviisti	PCLE_TYHMÄSTI	opt
ilmavasti	PCLE_NOPEASTI	opt
ilmeettömästi	PCLE_TYHMÄSTI	opt
ilmeikkäästi	PCLE_TYHMÄSTI	opt
ilmeisesti	PCLE_TYHMÄSTI	opt
ilmielävästi	PCLE_TYHMÄSTI	opt
ilmiselvästi	PCLE_TYHMÄSTI	opt
ilmiömäisesti	PCLE_TYHMÄSTI	opt
iloisesti	PCLE_NOPEASTI	opt
ilottomasti	PCLE_NOPEASTI	opt
imelästi	PCLE_TYHMÄSTI	opt
implisiittisesti	PCLE_TYHMÄSTI	opt
impulsiivisesti	PCLE_NOPEASTI	opt
individualistisesti	PCLE_NOPEASTI	opt
inhimillisesti	PCLE_TYHMÄSTI	opt
inhottavasti	PCLE_NOPEASTI	opt
innokkaasti	PCLE_NOPEASTI	opt
innostuneesti	PCLE_NOPEASTI	opt
innottomasti	PCLE_NOPEASTI	opt
intensiivisesti	PCLE_TYHMÄSTI	opt
interaktiivisesti	PCLE_NOPEASTI	opt
intertekstuaalisesti	PCLE_NOPEASTI	opt
intiimisti	PCLE_TYHMÄSTI	opt
intohimoisesti	PCLE_NOPEASTI	opt
intohimottomasti	PCLE_NOPEASTI	opt
intomielisesti	PCLE_TYHMÄSTI	opt
intuitiivisesti	PCLE_NOPEASTI	opt
ironisesti	PCLE_NOPEASTI	opt
irrallisesti	PCLE_NOPEASTI	opt
irrationaalisesti	PCLE_NOPEASTI	opt
irstaasti	PCLE_NOPEASTI	opt
irtonaisesti	PCLE_NOPEASTI	opt
irvokkaasti	PCLE_NOPEASTI	opt
iskevästi	PCLE_TYHMÄSTI	opt
isosti	PCLE_NOPEASTI	opt
isällisesti	PCLE_TYHMÄSTI	opt
isänmaallisesti	PCLE_NOPEASTI	opt
itarasti	PCLE_NOPEASTI	opt
itse	PCLE_TYHMÄSTI	opt
itsekeskeisesti	PCLE_TYHMÄSTI	opt
itsekkäästi	PCLE_TYHMÄSTI	opt
itsenäisesti	PCLE_TYHMÄSTI	opt
itsepintaisesti	PCLE_NOPEASTI	opt
itsepäisesti	PCLE_TYHMÄSTI	opt
itserakkaasti	PCLE_NOPEASTI	opt
itseriittoisesti	PCLE_NOPEASTI	opt
itsetietoisesti	PCLE_NOPEASTI	opt
itsetyytyväisesti	PCLE_TYHMÄSTI	opt
itsevaltaisesti	PCLE_NOPEASTI	opt
itsevaltiaasti	PCLE_NOPEASTI	opt
itsevarmasti	PCLE_NOPEASTI	opt
ivallisesti	PCLE_NOPEASTI	opt
iäisesti	PCLE_TYHMÄSTI	opt
iänikuisesti	PCLE_NOPEASTI	opt
jaetusti	PCLE_NOPEASTI	opt
jaksoittain	PCLE_NOPEASTI	opt
jaksoittaisesti	PCLE_NOPEASTI	opt
jalomielisesti	PCLE_TYHMÄSTI	opt
jatkuvasti	PCLE_NOPEASTI	opt
johdonmukaisesti	PCLE_NOPEASTI	opt
johtuen	PCLE_VALTAAN	opt
jos	PCLE_VAAN	opt
jouheasti	PCLE_NOPEASTI	opt
joukoittain	PCLE_NOPEASTI	opt
joustavasti	PCLE_NOPEASTI	opt
joutuisasti	PCLE_NOPEASTI	opt
juhlallisesti	PCLE_NOPEASTI	opt
juhlavasti	PCLE_NOPEASTI	opt
julkeasti	PCLE_NOPEASTI	opt
julkisesti	PCLE_NOPEASTI	opt
julmasti	PCLE_NOPEASTI	opt
julmetusti	PCLE_NOPEASTI	opt
jumalaisesti	PCLE_NOPEASTI	opt
jumalattomasti	PCLE_NOPEASTI	opt
jumalisesti	PCLE_NOPEASTI	opt
juoheasti	PCLE_NOPEASTI	opt
juohevasti	PCLE_NOPEASTI	opt
juoksevasti	PCLE_NOPEASTI	opt
juonellisesti	PCLE_NOPEASTI	opt
juonikkaasti	PCLE_NOPEASTI	opt
juridisesti	PCLE_NOPEASTI	opt
jurosti	PCLE_NOPEASTI	opt
juurijajuuri	PCLE_VUOKSI	opt
jyhkeästi	PCLE_TYHMÄSTI	opt
jykevästi	PCLE_TYHMÄSTI	opt
jylhästi	PCLE_TYHMÄSTI	opt
jyrkästi	PCLE_TYHMÄSTI	opt
jähmeästi	PCLE_TYHMÄSTI	opt
jälkeen	PCLE_NÄKYVIIN	opt
jämerästi	PCLE_TYHMÄSTI	opt
jämptisti	PCLE_TYHMÄSTI	opt
jämttisti	PCLE_TYHMÄSTI	opt
jämäkästi	PCLE_TYHMÄSTI	opt
jännittävästi	PCLE_TYHMÄSTI	opt
jännästi	PCLE_TYHMÄSTI	opt
jänskästi	PCLE_TYHMÄSTI	opt
jäntevästi	PCLE_TYHMÄSTI	opt
järeästi	PCLE_TYHMÄSTI	opt
järjellisesti	PCLE_TYHMÄSTI	opt
järjestelmällisesti	PCLE_TYHMÄSTI	opt
järjettömästi	PCLE_TYHMÄSTI	opt
järkevästi	PCLE_TYHMÄSTI	opt
järkiperäisesti	PCLE_TYHMÄSTI	opt
järkkymättömästi	PCLE_TYHMÄSTI	opt
järkyttävästi	PCLE_TYHMÄSTI	opt
järkähtämättömästi	PCLE_TYHMÄSTI	opt
jäyhästi	PCLE_TYHMÄSTI	opt
jäykästi	PCLE_TYHMÄSTI	opt
jäännöksettömästi	PCLE_TYHMÄSTI	opt
jääräpäisesti	PCLE_TYHMÄSTI	opt
jäätävästi	PCLE_TYHMÄSTI	opt
kaameasti	PCLE_NOPEASTI	opt
kaarevasti	PCLE_NOPEASTI	opt
kaavamaisesti	PCLE_NOPEASTI	opt
kahdenkeskisesti	PCLE_NOPEASTI	opt
kahdesti	PCLE_NOPEASTI	opt
kaihoisasti	PCLE_NOPEASTI	opt
kaiketi	PCLE_VUOKSI	opt
kaikuvasti	PCLE_NOPEASTI	opt
kainosti	PCLE_NOPEASTI	opt
kaksinapaisesti	PCLE_NOPEASTI	opt
kaksinkertaisesti	PCLE_NOPEASTI	opt
kaksittain	PCLE_NOPEASTI	opt
kalseasti	PCLE_NOPEASTI	opt
kamalasti	PCLE_NOPEASTI	opt
kammottavasti	PCLE_NOPEASTI	opt
kanamaisesti	PCLE_NOPEASTI	opt
kankeasti	PCLE_NOPEASTI	opt
kannuittain	PCLE_NOPEASTI	opt
kansainvälisesti	PCLE_TYHMÄSTI	opt
kansallisesti	PCLE_NOPEASTI	opt
kansanomaisesti	PCLE_NOPEASTI	opt
kansantajuisesti	PCLE_NOPEASTI	opt
kansanvaltaisesti	PCLE_NOPEASTI	opt
kantamuksittain	PCLE_NOPEASTI	opt
kaoottisesti	PCLE_NOPEASTI	opt
kapeasti	PCLE_NOPEASTI	opt
kapillaarisesti	PCLE_NOPEASTI	opt
kapoittain	PCLE_NOPEASTI	opt
kappaleittain	PCLE_NOPEASTI	opt
karheasti	PCLE_NOPEASTI	opt
karjalaisittain	PCLE_NOPEASTI	opt
karkeasti	PCLE_NOPEASTI	opt
karmeasti	PCLE_NOPEASTI	opt
karsaasti	PCLE_NOPEASTI	opt
karskisti	PCLE_NOPEASTI	opt
kartografisesti	PCLE_NOPEASTI	opt
karusti	PCLE_NOPEASTI	opt
karvaasti	PCLE_NOPEASTI	opt
kasoittain	PCLE_NOPEASTI	opt
katalasti	PCLE_NOPEASTI	opt
kategorisesti	PCLE_NOPEASTI	opt
katkerasti	PCLE_NOPEASTI	opt
katkonaisesti	PCLE_NOPEASTI	opt
katsoen	PCLE_VALTAAN	opt
kauheasti	PCLE_NOPEASTI	opt
kaukonäköisesti	PCLE_TYHMÄSTI	opt
kauniisti	PCLE_NOPEASTI	opt
kaunistelevasti	PCLE_NOPEASTI	opt
kaunopuheisesti	PCLE_NOPEASTI	opt
kaupallisesti	PCLE_NOPEASTI	opt
kaupungeittain	PCLE_NOPEASTI	opt
kaupunkilaisesti	PCLE_NOPEASTI	opt
kaupunkilaisittain	PCLE_NOPEASTI	opt
kausittain	PCLE_NOPEASTI	opt
kavalasti	PCLE_NOPEASTI	opt
kehnosti	PCLE_NOPEASTI	opt
kehuttavasti	PCLE_NOPEASTI	opt
keinotekoisesti	PCLE_NOPEASTI	opt
kekseliäästi	PCLE_TYHMÄSTI	opt
keljusti	PCLE_NOPEASTI	opt
kelvollisesti	PCLE_NOPEASTI	opt
kelvottomasti	PCLE_NOPEASTI	opt
kemiallisesti	PCLE_NOPEASTI	opt
kepeästi	PCLE_TYHMÄSTI	opt
kepulisti	PCLE_NOPEASTI	opt
kerkeästi	PCLE_TYHMÄSTI	opt
kernaasti	PCLE_NOPEASTI	opt
kerroksittain	PCLE_NOPEASTI	opt
-kertaisesti	PCLE_NOPEASTI	opt
kertakaikkisesti	PCLE_NOPEASTI	opt
keskeisesti	PCLE_TYHMÄSTI	opt
keskihakuisesti	PCLE_NOPEASTI	opt
keskimääräisesti	PCLE_TYHMÄSTI	opt
keskinkertaisesti	PCLE_NOPEASTI	opt
keskinäisesti	PCLE_TYHMÄSTI	opt
keskipakoisesti	PCLE_NOPEASTI	opt
kestävästi	PCLE_TYHMÄSTI	opt
kesysti	PCLE_TYHMÄSTI	opt
kesäisesti	PCLE_TYHMÄSTI	opt
ketterästi	PCLE_TYHMÄSTI	opt
keveästi	PCLE_TYHMÄSTI	opt
kevyesti	PCLE_TYHMÄSTI	opt
kevytmielisesti	PCLE_TYHMÄSTI	opt
keväisesti	PCLE_TYHMÄSTI	opt
kiehtovasti	PCLE_NOPEASTI	opt
kielellisesti	PCLE_TYHMÄSTI	opt
kielevästi	PCLE_TYHMÄSTI	opt
kieliopillisesti	PCLE_NOPEASTI	opt
kielteisesti	PCLE_TYHMÄSTI	opt
kierosti	PCLE_NOPEASTI	opt
kierroksittain	PCLE_NOPEASTI	opt
kierteisesti	PCLE_TYHMÄSTI	opt
kiihkeästi	PCLE_TYHMÄSTI	opt
kiihkoisasti	PCLE_NOPEASTI	opt
kiihkottomasti	PCLE_NOPEASTI	opt
kiinnostavasti	PCLE_NOPEASTI	opt
kiinteästi	PCLE_TYHMÄSTI	opt
kiintoisasti	PCLE_NOPEASTI	opt
kiireellisesti	PCLE_TYHMÄSTI	opt
kiireesti	PCLE_TYHMÄSTI	opt
kiireettömästi	PCLE_TYHMÄSTI	opt
kiireisesti	PCLE_TYHMÄSTI	opt
kiiruusti	PCLE_NOPEASTI	opt
kiistattomasti	PCLE_NOPEASTI	opt
kiistämättömästi	PCLE_TYHMÄSTI	opt
kiitettävästi	PCLE_TYHMÄSTI	opt
kiittämättömästi	PCLE_TYHMÄSTI	opt
kiivaasti	PCLE_NOPEASTI	opt
kiloittain	PCLE_NOPEASTI	opt
kilometreittäin	PCLE_TYHMÄSTI	opt
kiltisti	PCLE_TYHMÄSTI	opt
kimakasti	PCLE_NOPEASTI	opt
kimeästi	PCLE_TYHMÄSTI	opt
kimmoisasti	PCLE_NOPEASTI	opt
kimpuittain	PCLE_NOPEASTI	opt
kipakasti	PCLE_NOPEASTI	opt
kiperästi	PCLE_TYHMÄSTI	opt
kipeästi	PCLE_TYHMÄSTI	opt
kireästi	PCLE_TYHMÄSTI	opt
kirjaimellisesti	PCLE_NOPEASTI	opt
kirjallisesti	PCLE_NOPEASTI	opt
kirjanpidollisesti	PCLE_NOPEASTI	opt
kirjavasti	PCLE_NOPEASTI	opt
kirjeellisesti	PCLE_TYHMÄSTI	opt
kirkkaasti	PCLE_NOPEASTI	opt
kirkollisesti	PCLE_NOPEASTI	opt
kirotusti	PCLE_NOPEASTI	opt
kirpeästi	PCLE_TYHMÄSTI	opt
kirurgisesti	PCLE_NOPEASTI	opt
kitkattomasti	PCLE_NOPEASTI	opt
kitkerästi	PCLE_TYHMÄSTI	opt
kitsaasti	PCLE_NOPEASTI	opt
kituliaasti	PCLE_NOPEASTI	opt
kiukkuisesti	PCLE_NOPEASTI	opt
kiusallisesti	PCLE_NOPEASTI	opt
kivasti	PCLE_NOPEASTI	opt
kiverästi	PCLE_TYHMÄSTI	opt
kivuliaasti	PCLE_NOPEASTI	opt
kivuttomasti	PCLE_NOPEASTI	opt
klassisesti	PCLE_NOPEASTI	opt
kliinisesti	PCLE_TYHMÄSTI	opt
kodikkaasti	PCLE_NOPEASTI	opt
kohdittain	PCLE_NOPEASTI	opt
-kohtaisesti	PCLE_NOPEASTI	opt
kohtalaisesti	PCLE_NOPEASTI	opt
kohtalokkaasti	PCLE_NOPEASTI	opt
kohtauksittain	PCLE_NOPEASTI	opt
kohteliaasti	PCLE_NOPEASTI	opt
kohtisuorasti	PCLE_NOPEASTI	opt
kohtuullisesti	PCLE_NOPEASTI	opt
kohtuuttomasti	PCLE_NOPEASTI	opt
kokeellisesti	PCLE_NOPEASTI	opt
kokemusperäisesti	PCLE_TYHMÄSTI	opt
kokeneesti	PCLE_NOPEASTI	opt
kokonaisvaltaisesti	PCLE_NOPEASTI	opt
koleasti	PCLE_NOPEASTI	opt
kolkosti	PCLE_NOPEASTI	opt
kollektiivisesti	PCLE_NOPEASTI	opt
kolmasti	PCLE_NOPEASTI	opt
kolmesti	PCLE_NOPEASTI	opt
kolminkertaisesti	PCLE_NOPEASTI	opt
kolmittain	PCLE_NOPEASTI	opt
kolmiäänisesti	PCLE_TYHMÄSTI	opt
komeasti	PCLE_NOPEASTI	opt
koneellisesti	PCLE_NOPEASTI	opt
konemaisesti	PCLE_NOPEASTI	opt
konkreettisesti	PCLE_NOPEASTI	opt
konservatiivisesti	PCLE_NOPEASTI	opt
konstikkaasti	PCLE_NOPEASTI	opt
koomisesti	PCLE_NOPEASTI	opt
kopeasti	PCLE_NOPEASTI	opt
koppavasti	PCLE_NOPEASTI	opt
koreasti	PCLE_NOPEASTI	opt
koreittain	PCLE_NOPEASTI	opt
koristeellisesti	PCLE_NOPEASTI	opt
korjaamattomasti	PCLE_NOPEASTI	opt
korkeasti	PCLE_NOPEASTI	opt
korkeintaan	PCLE_VALTAAN	opt
korosteisesti	PCLE_NOPEASTI	opt
korrektisti	PCLE_NOPEASTI	opt
korskeasti	PCLE_NOPEASTI	opt
koruttomasti	PCLE_NOPEASTI	opt
koskien	PCLE_VALTAAN	opt
kosteasti	PCLE_NOPEASTI	opt
kotoisesti	PCLE_NOPEASTI	opt
kouraantuntuvasti	PCLE_NOPEASTI	opt
kouriintuntuvasti	PCLE_NOPEASTI	opt
kouristuksenomaisesti	PCLE_NOPEASTI	opt
kovakouraisesti	PCLE_NOPEASTI	opt
kovakätisesti	PCLE_TYHMÄSTI	opt
kovasti	PCLE_NOPEASTI	opt
kovasydämisesti	PCLE_TYHMÄSTI	opt
kovaäänisesti	PCLE_TYHMÄSTI	opt
kriittisesti	PCLE_TYHMÄSTI	opt
kristallinkirkkaasti	PCLE_NOPEASTI	opt
kristillisesti	PCLE_TYHMÄSTI	opt
kritiikittömästi	PCLE_TYHMÄSTI	opt
kronologisesti	PCLE_NOPEASTI	opt
kroonisesti	PCLE_NOPEASTI	opt
kuivakiskoisesti	PCLE_NOPEASTI	opt
kuivasti	PCLE_NOPEASTI	opt
kujeellisesti	PCLE_NOPEASTI	opt
kulauksittain	PCLE_NOPEASTI	opt
kulmikkaasti	PCLE_NOPEASTI	opt
kulmittain	PCLE_NOPEASTI	opt
kultaisesti	PCLE_NOPEASTI	opt
kulttuurisesti	PCLE_NOPEASTI	opt
kuluessa	PCLE_KOTONA	opt
kuluttua	PCLE_KOTONA	opt
kumeasti	PCLE_NOPEASTI	opt
kummallisesti	PCLE_NOPEASTI	opt
kummasti	PCLE_NOPEASTI	opt
kumoamattomasti	PCLE_NOPEASTI	opt
kuninkaallisesti	PCLE_NOPEASTI	opt
kunniakkaasti	PCLE_NOPEASTI	opt
kunniallisesti	PCLE_NOPEASTI	opt
kunnianhimoisesti	PCLE_NOPEASTI	opt
kunniattomasti	PCLE_NOPEASTI	opt
kunnioitettavasti	PCLE_NOPEASTI	opt
kunnioittavasti	PCLE_NOPEASTI	opt
kunnittain	PCLE_NOPEASTI	opt
kunnollisesti	PCLE_NOPEASTI	opt
kuolemanvakavasti	PCLE_NOPEASTI	opt
kuolettavasti	PCLE_NOPEASTI	opt
kuormittain	PCLE_NOPEASTI	opt
kurillisesti	PCLE_NOPEASTI	opt
kurittomasti	PCLE_NOPEASTI	opt
kurjasti	PCLE_NOPEASTI	opt
kursorisesti	PCLE_NOPEASTI	opt
kuudesti	PCLE_NOPEASTI	opt
kuukausittain	PCLE_NOPEASTI	opt
kuuliaisesti	PCLE_NOPEASTI	opt
kuultavasti	PCLE_NOPEASTI	opt
kuulumattomasti	PCLE_NOPEASTI	opt
kuuluvasti	PCLE_NOPEASTI	opt
kuumasti	PCLE_NOPEASTI	opt
kuumaverisesti	PCLE_TYHMÄSTI	opt
kuumeisesti	PCLE_NOPEASTI	opt
kuuroittain	PCLE_NOPEASTI	opt
kuutioittain	PCLE_NOPEASTI	opt
kuutiollisesti	PCLE_NOPEASTI	opt
kuutiomaisesti	PCLE_NOPEASTI	opt
kuutiometreittäin	PCLE_TYHMÄSTI	opt
kuvaamattomasti	PCLE_NOPEASTI	opt
kuvaannollisesti	PCLE_NOPEASTI	opt
kuvallisesti	PCLE_NOPEASTI	opt
kvalitatiivisesti	PCLE_NOPEASTI	opt
kvantitatiivisesti	PCLE_NOPEASTI	opt
kyljittäin	PCLE_TYHMÄSTI	opt
kyllin	PCLE_NÄKYVIIN	opt
kylmäkiskoisesti	PCLE_NOPEASTI	opt
kylmäpäisesti	PCLE_TYHMÄSTI	opt
kylmästi	PCLE_TYHMÄSTI	opt
kylmäsydämisesti	PCLE_TYHMÄSTI	opt
kylmäverisesti	PCLE_TYHMÄSTI	opt
kymmenesti	PCLE_TYHMÄSTI	opt
kymmenittäin	PCLE_TYHMÄSTI	opt
kypsästi	PCLE_TYHMÄSTI	opt
kysyvästi	PCLE_TYHMÄSTI	opt
kyynisesti	PCLE_TYHMÄSTI	opt
käheästi	PCLE_TYHMÄSTI	opt
käheä-äänisesti	PCLE_TYHMÄSTI	opt
kärjekkäästi	PCLE_TYHMÄSTI	opt
kärkevästi	PCLE_TYHMÄSTI	opt
kärkkäästi	PCLE_TYHMÄSTI	opt
kärsimättömästi	PCLE_TYHMÄSTI	opt
kärsivällisesti	PCLE_TYHMÄSTI	opt
kärttyisästi	PCLE_TYHMÄSTI	opt
käsin	PCLE_NÄKYVIIN	opt
käsiteollisesti	PCLE_NOPEASTI	opt
käsitteellisesti	PCLE_TYHMÄSTI	opt
käsittämättömästi	PCLE_TYHMÄSTI	opt
käsivaraisesti	PCLE_NOPEASTI	opt
kätevästi	PCLE_TYHMÄSTI	opt
-kätisesti	PCLE_TYHMÄSTI	opt
käytännöllisesti	PCLE_TYHMÄSTI	opt
käyvästi	PCLE_TYHMÄSTI	opt
käänteentekevästi	PCLE_TYHMÄSTI	opt
käänteisesti	PCLE_TYHMÄSTI	opt
kömpelösti	PCLE_TYHMÄSTI	opt
köpelösti	PCLE_TYHMÄSTI	opt
köyhästi	PCLE_TYHMÄSTI	opt
köykäisesti	PCLE_TYHMÄSTI	opt
laadukkaasti	PCLE_NOPEASTI	opt
laadullisesti	PCLE_NOPEASTI	opt
laaja-alaisesti	PCLE_NOPEASTI	opt
laajasti	PCLE_NOPEASTI	opt
laatuunkäyvästi	PCLE_TYHMÄSTI	opt
labiilisti	PCLE_NOPEASTI	opt
lahjakkaasti	PCLE_NOPEASTI	opt
lahjomattomasti	PCLE_NOPEASTI	opt
laikuittain	PCLE_NOPEASTI	opt
laillisesti	PCLE_NOPEASTI	opt
lainmukaisesti	PCLE_NOPEASTI	opt
lainvastaisesti	PCLE_NOPEASTI	opt
laiskasti	PCLE_NOPEASTI	opt
laitaan	PCLE_VALTAAN	opt
laittamattomasti	PCLE_NOPEASTI	opt
laittomasti	PCLE_NOPEASTI	opt
lakimääräisesti	PCLE_TYHMÄSTI	opt
lakonisesti	PCLE_NOPEASTI	opt
lammasmaisesti	PCLE_NOPEASTI	opt
lapsekkaasti	PCLE_NOPEASTI	opt
lapsellisesti	PCLE_NOPEASTI	opt
lapsenomaisesti	PCLE_NOPEASTI	opt
lapsentajuisesti	PCLE_NOPEASTI	opt
laseittain	PCLE_NOPEASTI	opt
laskennallisesti	PCLE_NOPEASTI	opt
latteasti	PCLE_NOPEASTI	opt
lauhkeasti	PCLE_NOPEASTI	opt
laulavasti	PCLE_NOPEASTI	opt
laumoittain	PCLE_NOPEASTI	opt
laupiaasti	PCLE_NOPEASTI	opt
laveasanaisesti	PCLE_NOPEASTI	opt
laveasti	PCLE_NOPEASTI	opt
leikillisesti	PCLE_TYHMÄSTI	opt
leikisti	PCLE_TYHMÄSTI	opt
leikkisästi	PCLE_TYHMÄSTI	opt
lemmekkäästi	PCLE_TYHMÄSTI	opt
lempeästi	PCLE_TYHMÄSTI	opt
lennokkaasti	PCLE_NOPEASTI	opt
leppeästi	PCLE_TYHMÄSTI	opt
leppoisasti	PCLE_NOPEASTI	opt
leppymättömästi	PCLE_TYHMÄSTI	opt
lepsusti	PCLE_NOPEASTI	opt
letkeästi	PCLE_TYHMÄSTI	opt
leudosti	PCLE_NOPEASTI	opt
leuhkasti	PCLE_NOPEASTI	opt
leukavasti	PCLE_NOPEASTI	opt
leveästi	PCLE_TYHMÄSTI	opt
levollisesti	PCLE_NOPEASTI	opt
levottomasti	PCLE_NOPEASTI	opt
leväperäisesti	PCLE_TYHMÄSTI	opt
liberaalisesti	PCLE_NOPEASTI	opt
liberaalisti	PCLE_NOPEASTI	opt
liehakkaasti	PCLE_NOPEASTI	opt
lievästi	PCLE_TYHMÄSTI	opt
liiketaloudellisesti	PCLE_NOPEASTI	opt
liikkuvasti	PCLE_NOPEASTI	opt
liikuttavasti	PCLE_NOPEASTI	opt
likeisesti	PCLE_TYHMÄSTI	opt
likimääräisesti	PCLE_TYHMÄSTI	opt
limittäin	PCLE_TYHMÄSTI	opt
linjakkaasti	PCLE_NOPEASTI	opt
lipettiin	PCLE_NÄKYVIIN	opt
lipevästi	PCLE_TYHMÄSTI	opt
lisäksi	PCLE_LISÄKSI	opt
litroittain	PCLE_NOPEASTI	opt
liukkaasti	PCLE_NOPEASTI	opt
liukuvasti	PCLE_NOPEASTI	opt
lohduttomasti	PCLE_NOPEASTI	opt
loistavasti	PCLE_NOPEASTI	opt
loisteliaasti	PCLE_NOPEASTI	opt
loivasti	PCLE_NOPEASTI	opt
lojaalisesti	PCLE_NOPEASTI	opt
lojaalisti	PCLE_NOPEASTI	opt
lokaalisesti	PCLE_NOPEASTI	opt
lokoisasti	PCLE_NOPEASTI	opt
lomittain	PCLE_NOPEASTI	opt
loogisesti	PCLE_NOPEASTI	opt
loppumattomasti	PCLE_NOPEASTI	opt
lopullisesti	PCLE_NOPEASTI	opt
lopulta	PCLE_KOTONA	opt
loputtomasti	PCLE_NOPEASTI	opt
luihusti	PCLE_NOPEASTI	opt
lujakätisesti	PCLE_TYHMÄSTI	opt
lujasti	PCLE_NOPEASTI	opt
lukuisasti	PCLE_NOPEASTI	opt
lukumääräisesti	PCLE_TYHMÄSTI	opt
lukuun ottamatta	PCLE_KOTONA	opt
lunkisti	PCLE_NOPEASTI	opt
luonnikkaasti	PCLE_NOPEASTI	opt
luonnollisesti	PCLE_NOPEASTI	opt
luonnonmukaisesti	PCLE_NOPEASTI	opt
luonnottomasti	PCLE_NOPEASTI	opt
luontaisesti	PCLE_NOPEASTI	opt
luonteenomaisesti	PCLE_NOPEASTI	opt
luonteisesti	PCLE_NOPEASTI	opt
luontevasti	PCLE_NOPEASTI	opt
luotaantyöntävästi	PCLE_TYHMÄSTI	opt
luotettavasti	PCLE_NOPEASTI	opt
luottamuksellisesti	PCLE_NOPEASTI	opt
luottavaisesti	PCLE_NOPEASTI	opt
luovasti	PCLE_NOPEASTI	opt
lupaavasti	PCLE_NOPEASTI	opt
lupsakasti	PCLE_NOPEASTI	opt
lupsakkaasti	PCLE_NOPEASTI	opt
lurjusmaisesti	PCLE_NOPEASTI	opt
luultavasti	PCLE_NOPEASTI	opt
luvallisesti	PCLE_NOPEASTI	opt
luvattomasti	PCLE_NOPEASTI	opt
luvuttomasti	PCLE_NOPEASTI	opt
lyhyesti	PCLE_TYHMÄSTI	opt
lyhykäisesti	PCLE_TYHMÄSTI	opt
lyhytjännitteisesti	PCLE_TYHMÄSTI	opt
lyhytjänteisesti	PCLE_TYHMÄSTI	opt
lyhytnäköisesti	PCLE_TYHMÄSTI	opt
lyhytsanaisesti	PCLE_NOPEASTI	opt
lystikkäästi	PCLE_TYHMÄSTI	opt
lyyrisesti	PCLE_TYHMÄSTI	opt
läheisesti	PCLE_TYHMÄSTI	opt
lähtemättömästi	PCLE_TYHMÄSTI	opt
lähtien	PCLE_NÄKYVIIN	opt
läjittäin	PCLE_TYHMÄSTI	opt
lämpimästi	PCLE_TYHMÄSTI	opt
lämpöisesti	PCLE_TYHMÄSTI	opt
länsimaisesti	PCLE_NOPEASTI	opt
läpikotaisesti	PCLE_NOPEASTI	opt
läpitunkevasti	PCLE_NOPEASTI	opt
lääketieteellisesti	PCLE_TYHMÄSTI	opt
lääneittäin	PCLE_TYHMÄSTI	opt
löperösti	PCLE_TYHMÄSTI	opt
löyhästi	PCLE_TYHMÄSTI	opt
löysästi	PCLE_TYHMÄSTI	opt
maagisesti	PCLE_NOPEASTI	opt
maailmanhistoriallisesti	PCLE_NOPEASTI	opt
maailmanlaajuisesti	PCLE_NOPEASTI	opt
maalaisesti	PCLE_NOPEASTI	opt
maalaisittain	PCLE_NOPEASTI	opt
maalaismaisesti	PCLE_NOPEASTI	opt
maalauksellisesti	PCLE_NOPEASTI	opt
maantieteellisesti	PCLE_TYHMÄSTI	opt
magneettisesti	PCLE_NOPEASTI	opt
mahdikkaasti	PCLE_NOPEASTI	opt
mahdollisesti	PCLE_NOPEASTI	opt
mahdottomasti	PCLE_NOPEASTI	opt
mahtailevasti	PCLE_NOPEASTI	opt
mahtavasti	PCLE_NOPEASTI	opt
mahtipontisesti	PCLE_NOPEASTI	opt
maineikkaasti	PCLE_NOPEASTI	opt
mainittavasti	PCLE_NOPEASTI	opt
mainonnallisesti	PCLE_NOPEASTI	opt
maireasti	PCLE_NOPEASTI	opt
mairittelevasti	PCLE_NOPEASTI	opt
maittain	PCLE_NOPEASTI	opt
majesteettisesti	PCLE_NOPEASTI	opt
makeasti	PCLE_NOPEASTI	opt
maksuttomasti	PCLE_NOPEASTI	opt
mallikelpoisesti	PCLE_NOPEASTI	opt
mallikkaasti	PCLE_NOPEASTI	opt
maltillisesti	PCLE_NOPEASTI	opt
maltittomasti	PCLE_NOPEASTI	opt
malttamattomasti	PCLE_NOPEASTI	opt
maneerimaisesti	PCLE_NOPEASTI	opt
mannermaisesti	PCLE_NOPEASTI	opt
manuaalisesti	PCLE_NOPEASTI	opt
markkamääräisesti	PCLE_TYHMÄSTI	opt
masentuneesti	PCLE_NOPEASTI	opt
masokistisesti	PCLE_NOPEASTI	opt
massiivisesti	PCLE_NOPEASTI	opt
massoittain	PCLE_NOPEASTI	opt
matalamielisesti	PCLE_TYHMÄSTI	opt
matelevasti	PCLE_NOPEASTI	opt
materialistisesti	PCLE_NOPEASTI	opt
matkailullisesti	PCLE_NOPEASTI	opt
maukkaasti	PCLE_NOPEASTI	opt
mauttomasti	PCLE_NOPEASTI	opt
mehevästi	PCLE_TYHMÄSTI	opt
mehukkaasti	PCLE_NOPEASTI	opt
meikäläisittäin	PCLE_TYHMÄSTI	opt
mekaanisesti	PCLE_NOPEASTI	opt
melankolisesti	PCLE_NOPEASTI	opt
melkoisesti	PCLE_NOPEASTI	opt
melodisesti	PCLE_NOPEASTI	opt
melodramaattisesti	PCLE_NOPEASTI	opt
meluisasti	PCLE_NOPEASTI	opt
menestyksekkäästi	PCLE_TYHMÄSTI	opt
menestyksellisesti	PCLE_TYHMÄSTI	opt
mennessä	PCLE_IKINÄ	opt
mentaalisesti	PCLE_NOPEASTI	opt
merisotilaallisesti	PCLE_NOPEASTI	opt
merkillisesti	PCLE_TYHMÄSTI	opt
merkitsevästi	PCLE_TYHMÄSTI	opt
merkittävästi	PCLE_TYHMÄSTI	opt
mestarillisesti	PCLE_NOPEASTI	opt
metaforisesti	PCLE_NOPEASTI	opt
metkasti	PCLE_NOPEASTI	opt
metodisesti	PCLE_NOPEASTI	opt
metreittäin	PCLE_TYHMÄSTI	opt
metsänhoidollisesti	PCLE_NOPEASTI	opt
miedosti	PCLE_NOPEASTI	opt
miehekkäästi	PCLE_TYHMÄSTI	opt
miehevästi	PCLE_TYHMÄSTI	opt
miehuullisesti	PCLE_NOPEASTI	opt
mielekkäästi	PCLE_TYHMÄSTI	opt
mielenkiinnottomasti	PCLE_NOPEASTI	opt
mielenkiintoisesti	PCLE_NOPEASTI	opt
mielenosoituksellisesti	PCLE_NOPEASTI	opt
mielenterveydellisesti	PCLE_TYHMÄSTI	opt
mielettömästi	PCLE_TYHMÄSTI	opt
mielevästi	PCLE_TYHMÄSTI	opt
mielikuvituksekkaasti	PCLE_NOPEASTI	opt
mielipuolisesti	PCLE_NOPEASTI	opt
-mielisesti	PCLE_TYHMÄSTI	opt
mielivaltaisesti	PCLE_NOPEASTI	opt
miellyttävästi	PCLE_TYHMÄSTI	opt
mieluisasti	PCLE_NOPEASTI	opt
mieluisesti	PCLE_NOPEASTI	opt
mieluusti	PCLE_NOPEASTI	opt
mieskohtaisesti	PCLE_NOPEASTI	opt
mieslukuisesti	PCLE_NOPEASTI	opt
miesmäisesti	PCLE_TYHMÄSTI	opt
mietteliäästi	PCLE_TYHMÄSTI	opt
miettiväisesti	PCLE_TYHMÄSTI	opt
miimisesti	PCLE_TYHMÄSTI	opt
mikroskooppisesti	PCLE_NOPEASTI	opt
miljoonittain	PCLE_NOPEASTI	opt
minuuteittain	PCLE_NOPEASTI	opt
mittaamattomasti	PCLE_NOPEASTI	opt
modernisti	PCLE_NOPEASTI	opt
moitittavasti	PCLE_NOPEASTI	opt
moitteettomasti	PCLE_NOPEASTI	opt
moittivasti	PCLE_NOPEASTI	opt
molemminpuolisesti	PCLE_NOPEASTI	opt
monasti	PCLE_NOPEASTI	opt
monesti	PCLE_NOPEASTI	opt
monilukuisesti	PCLE_NOPEASTI	opt
monimielisesti	PCLE_NOPEASTI	opt
moninkertaisesti	PCLE_NOPEASTI	opt
monipuolisesti	PCLE_NOPEASTI	opt
monisanaisesti	PCLE_NOPEASTI	opt
monisatakertaisesti	PCLE_NOPEASTI	opt
monituhatkertaisesti	PCLE_NOPEASTI	opt
monotonisesti	PCLE_NOPEASTI	opt
monumentaalisesti	PCLE_NOPEASTI	opt
moraalisesti	PCLE_NOPEASTI	opt
moraalittomasti	PCLE_NOPEASTI	opt
moukkamaisesti	PCLE_NOPEASTI	opt
muhkeasti	PCLE_NOPEASTI	opt
muikeasti	PCLE_NOPEASTI	opt
mukaansatempaavasti	PCLE_NOPEASTI	opt
mukaisesti	PCLE_NOPEASTI	opt
mukavasti	PCLE_NOPEASTI	opt
mukiinmenevästi	PCLE_TYHMÄSTI	opt
mullistavasti	PCLE_NOPEASTI	opt
muodikkaasti	PCLE_NOPEASTI	opt
muodinmukaisesti	PCLE_NOPEASTI	opt
muodollisesti	PCLE_NOPEASTI	opt
muodossa	PCLE_KOTONA	opt
murhaavasti	PCLE_NOPEASTI	opt
murheellisesti	PCLE_NOPEASTI	opt
murskaavasti	PCLE_NOPEASTI	opt
murteellisesti	PCLE_NOPEASTI	opt
murteittain	PCLE_NOPEASTI	opt
musiikillisesti	PCLE_NOPEASTI	opt
musikaalisesti	PCLE_NOPEASTI	opt
mustasukkaisesti	PCLE_NOPEASTI	opt
mutkattomasti	PCLE_NOPEASTI	opt
mutkikkaasti	PCLE_NOPEASTI	opt
mutta	PCLE_KOTONA	opt
muukalaisittain	PCLE_NOPEASTI	opt
muuten	PCLE_VALTAAN	opt
muutoin	PCLE_VALTAAN	opt
myrkyllisesti	PCLE_TYHMÄSTI	opt
myrskyisästi	PCLE_TYHMÄSTI	opt
mystisesti	PCLE_TYHMÄSTI	opt
myönteisesti	PCLE_TYHMÄSTI	opt
myöntyvästi	PCLE_TYHMÄSTI	opt
myöntävästi	PCLE_TYHMÄSTI	opt
myöten	PCLE_NÄKYVIIN	opt
myötäisesti	PCLE_TYHMÄSTI	opt
myötämielisesti	PCLE_TYHMÄSTI	opt
myötätuntoisesti	PCLE_NOPEASTI	opt
määräilevästi	PCLE_TYHMÄSTI	opt
määräisesti	PCLE_TYHMÄSTI	opt
määrällisesti	PCLE_TYHMÄSTI	opt
määrätietoisesti	PCLE_NOPEASTI	opt
määrättömästi	PCLE_TYHMÄSTI	opt
määräävästi	PCLE_TYHMÄSTI	opt
naftisti	PCLE_NOPEASTI	opt
naiivisti	PCLE_NOPEASTI	opt
naisellisesti	PCLE_NOPEASTI	opt
naismaisesti	PCLE_NOPEASTI	opt
napakasti	PCLE_NOPEASTI	opt
narrimaisesti	PCLE_NOPEASTI	opt
narsistisesti	PCLE_NOPEASTI	opt
nasevasti	PCLE_NOPEASTI	opt
naurettavasti	PCLE_NOPEASTI	opt
nautinnollisesti	PCLE_NOPEASTI	opt
nautittavasti	PCLE_NOPEASTI	opt
navakasti	PCLE_NOPEASTI	opt
negatiivisesti	PCLE_NOPEASTI	opt
neitseellisesti	PCLE_TYHMÄSTI	opt
nelikätisesti	PCLE_TYHMÄSTI	opt
nelinkertaisesti	PCLE_NOPEASTI	opt
nelittäin	PCLE_TYHMÄSTI	opt
neliäänisesti	PCLE_TYHMÄSTI	opt
neliöittäin	PCLE_TYHMÄSTI	opt
neliömetreittäin	PCLE_TYHMÄSTI	opt
neljännesvuosittain	PCLE_NOPEASTI	opt
neljästi	PCLE_TYHMÄSTI	opt
nenäkkäästi	PCLE_TYHMÄSTI	opt
nerokkaasti	PCLE_NOPEASTI	opt
neutraalisti	PCLE_NOPEASTI	opt
neuvokkaasti	PCLE_NOPEASTI	opt
nidoksittain	PCLE_NOPEASTI	opt
nihkeästi	PCLE_TYHMÄSTI	opt
niin sanotusti	PCLE_NOPEASTI	opt
niinikään	PCLE_NÄKYVIIN	opt
nimellisesti	PCLE_TYHMÄSTI	opt
nimenomaisesti	PCLE_NOPEASTI	opt
nimittäin	PCLE_TYHMÄSTI	opt
nipinnapin	PCLE_VALTAAN	opt
nipuittain	PCLE_NOPEASTI	opt
nirsosti	PCLE_NOPEASTI	opt
niukasti	PCLE_NOPEASTI	opt
niukkasanaisesti	PCLE_NOPEASTI	opt
nokittain	PCLE_NOPEASTI	opt
nokkavasti	PCLE_NOPEASTI	opt
nokkelasti	PCLE_NOPEASTI	opt
nolosti	PCLE_NOPEASTI	opt
nopeasti	PCLE_NOPEASTI	opt
nopsasti	PCLE_NOPEASTI	opt
normaalisti	PCLE_NOPEASTI	opt
nostalgisesti	PCLE_NOPEASTI	opt
notkeasti	PCLE_NOPEASTI	opt
nousukasmaisesti	PCLE_NOPEASTI	opt
nuhteettomasti	PCLE_NOPEASTI	opt
nuivasti	PCLE_NOPEASTI	opt
numerollisesti	PCLE_NOPEASTI	opt
nuorekkaasti	PCLE_NOPEASTI	opt
nurinkurisesti	PCLE_NOPEASTI	opt
nurjamielisesti	PCLE_TYHMÄSTI	opt
nurjasti	PCLE_NOPEASTI	opt
nurkittain	PCLE_NOPEASTI	opt
nuukasti	PCLE_NOPEASTI	opt
nykyaikaisesti	PCLE_NOPEASTI	opt
nykäyksittäin	PCLE_TYHMÄSTI	opt
nyreästi	PCLE_TYHMÄSTI	opt
nyrpeästi	PCLE_TYHMÄSTI	opt
näennäisesti	PCLE_TYHMÄSTI	opt
nähden	PCLE_NÄHDEN	opt
nähtävästi	PCLE_TYHMÄSTI	opt
näinollen	PCLE_VALTAAN	opt
näkymättömästi	PCLE_TYHMÄSTI	opt
näkyvästi	PCLE_TYHMÄSTI	opt
näppärästi	PCLE_TYHMÄSTI	opt
näpsäkästi	PCLE_TYHMÄSTI	opt
näpsästi	PCLE_TYHMÄSTI	opt
näpäkästi	PCLE_TYHMÄSTI	opt
nätisti	PCLE_TYHMÄSTI	opt
nöyrästi	PCLE_TYHMÄSTI	opt
objektiivisesti	PCLE_NOPEASTI	opt
odotetusti	PCLE_NOPEASTI	opt
odottamattomasti	PCLE_NOPEASTI	opt
odotuksenmukaisesti	PCLE_NOPEASTI	opt
odotuksenvastaisesti	PCLE_NOPEASTI	opt
ohimenevästi	PCLE_TYHMÄSTI	opt
ohjelmallisesti	PCLE_NOPEASTI	opt
ohraisesti	PCLE_NOPEASTI	opt
ohuesti	PCLE_NOPEASTI	opt
oikea-aikaisesti	PCLE_NOPEASTI	opt
oikeamielisesti	PCLE_TYHMÄSTI	opt
oikeaoppisesti	PCLE_NOPEASTI	opt
oikeasti	PCLE_NOPEASTI	opt
oikeestaan	PCLE_VALTAAN	opt
oikein	PCLE_VALTAAN	opt
oikeudellisesti	PCLE_NOPEASTI	opt
oikeudenmukaisesti	PCLE_NOPEASTI	opt
oikeudenvastaisesti	PCLE_NOPEASTI	opt
oikeudettomasti	PCLE_NOPEASTI	opt
oikeutetusti	PCLE_NOPEASTI	opt
oikukkaasti	PCLE_NOPEASTI	opt
oikullisesti	PCLE_NOPEASTI	opt
oivallisesti	PCLE_NOPEASTI	opt
olennaisesti	PCLE_NOPEASTI	opt
oletettavasti	PCLE_NOPEASTI	opt
oma-aloitteisesti	PCLE_NOPEASTI	opt
omaehtoisesti	PCLE_NOPEASTI	opt
omahyväisesti	PCLE_TYHMÄSTI	opt
-omaisesti	PCLE_NOPEASTI	opt
omakohtaisesti	PCLE_NOPEASTI	opt
omakätisesti	PCLE_TYHMÄSTI	opt
omalaatuisesti	PCLE_NOPEASTI	opt
omaperäisesti	PCLE_TYHMÄSTI	opt
omapäisesti	PCLE_TYHMÄSTI	opt
omatoimisesti	PCLE_NOPEASTI	opt
omavaltaisesti	PCLE_NOPEASTI	opt
omavastuisesti	PCLE_NOPEASTI	opt
ominaisesti	PCLE_NOPEASTI	opt
omintakeisesti	PCLE_NOPEASTI	opt
omistushaluisesti	PCLE_NOPEASTI	opt
omituisesti	PCLE_NOPEASTI	opt
ongelmallisesti	PCLE_NOPEASTI	opt
onnekkaasti	PCLE_NOPEASTI	opt
onnellisesti	PCLE_NOPEASTI	opt
onnettomasti	PCLE_NOPEASTI	opt
onnistuneesti	PCLE_NOPEASTI	opt
ontosti	PCLE_NOPEASTI	opt
operatiivisesti	PCLE_NOPEASTI	opt
opettavaisesti	PCLE_NOPEASTI	opt
opettavasti	PCLE_NOPEASTI	opt
opillisesti	PCLE_NOPEASTI	opt
oppineesti	PCLE_NOPEASTI	opt
optimistisesti	PCLE_NOPEASTI	opt
optisesti	PCLE_NOPEASTI	opt
oraakkelimaisesti	PCLE_NOPEASTI	opt
orgaanisesti	PCLE_NOPEASTI	opt
orjallisesti	PCLE_NOPEASTI	opt
orjamaisesti	PCLE_NOPEASTI	opt
osaaottavasti	PCLE_NOPEASTI	opt
osapäivätoimisesti	PCLE_NOPEASTI	opt
osittain	PCLE_NOPEASTI	opt
osuvasti	PCLE_NOPEASTI	opt
otaksuttavasti	PCLE_NOPEASTI	opt
otollisesti	PCLE_NOPEASTI	opt
oudosti	PCLE_NOPEASTI	opt
ovelasti	PCLE_NOPEASTI	opt
paatoksellisesti	PCLE_NOPEASTI	opt
pahanilkisesti	PCLE_TYHMÄSTI	opt
pahankurisesti	PCLE_NOPEASTI	opt
pahanlaisesti	PCLE_NOPEASTI	opt
pahanpäiväisesti	PCLE_TYHMÄSTI	opt
pahansuovasti	PCLE_NOPEASTI	opt
pahantuulisesti	PCLE_NOPEASTI	opt
pahasti	PCLE_NOPEASTI	opt
paheellisesti	PCLE_NOPEASTI	opt
pahuksesti	PCLE_NOPEASTI	opt
paikallisesti	PCLE_NOPEASTI	opt
paikkakunnittain	PCLE_NOPEASTI	opt
paikoittain	PCLE_NOPEASTI	opt
painavasti	PCLE_NOPEASTI	opt
-painoisesti	PCLE_NOPEASTI	opt
painokkaasti	PCLE_NOPEASTI	opt
-painotteisesti	PCLE_NOPEASTI	opt
paitsi	PCLE_VUOKSI	opt
pakanasti	PCLE_NOPEASTI	opt
pakottomasti	PCLE_NOPEASTI	opt
paksusti	PCLE_NOPEASTI	opt
palkattomasti	PCLE_NOPEASTI	opt
paloittain	PCLE_NOPEASTI	opt
palstoittain	PCLE_NOPEASTI	opt
palvovasti	PCLE_NOPEASTI	opt
papillisesti	PCLE_NOPEASTI	opt
paradoksaalisesti	PCLE_NOPEASTI	opt
parantumattomasti	PCLE_NOPEASTI	opt
pareittain	PCLE_NOPEASTI	opt
parittain	PCLE_NOPEASTI	opt
parlamentaarisesti	PCLE_NOPEASTI	opt
parodisesti	PCLE_NOPEASTI	opt
parvittain	PCLE_NOPEASTI	opt
pasifistisesti	PCLE_NOPEASTI	opt
passiivisesti	PCLE_NOPEASTI	opt
pateettisesti	PCLE_NOPEASTI	opt
pedagogisesti	PCLE_NOPEASTI	opt
pedanttisesti	PCLE_NOPEASTI	opt
peevelisti	PCLE_TYHMÄSTI	opt
pehmeästi	PCLE_TYHMÄSTI	opt
peijakkaasti	PCLE_NOPEASTI	opt
peitellysti	PCLE_TYHMÄSTI	opt
peitetysti	PCLE_TYHMÄSTI	opt
pelkurimaisesti	PCLE_NOPEASTI	opt
pelkästään	PCLE_NÄKYVIIN	opt
pelokkaasti	PCLE_NOPEASTI	opt
pelottavasti	PCLE_NOPEASTI	opt
pelottomasti	PCLE_NOPEASTI	opt
penikkamaisesti	PCLE_NOPEASTI	opt
pensasmaisesti	PCLE_NOPEASTI	opt
penseästi	PCLE_TYHMÄSTI	opt
penteleesti	PCLE_TYHMÄSTI	opt
pentumaisesti	PCLE_NOPEASTI	opt
perhanasti	PCLE_NOPEASTI	opt
perheittäin	PCLE_TYHMÄSTI	opt
perinnäisesti	PCLE_TYHMÄSTI	opt
perinpohjaisesti	PCLE_NOPEASTI	opt
perinteellisesti	PCLE_TYHMÄSTI	opt
perinteisesti	PCLE_TYHMÄSTI	opt
periodeittain	PCLE_NOPEASTI	opt
periodisesti	PCLE_NOPEASTI	opt
perkeleesti	PCLE_TYHMÄSTI	opt
persoonallisesti	PCLE_NOPEASTI	opt
persoonattomasti	PCLE_NOPEASTI	opt
perusteella	PCLE_KOTONA	opt
perusteellisesti	PCLE_NOPEASTI	opt
perusteettomasti	PCLE_NOPEASTI	opt
perustuen	PCLE_VALTAAN	opt
perustuslaillisesti	PCLE_NOPEASTI	opt
peruuttamattomasti	PCLE_NOPEASTI	opt
peräkkäisesti	PCLE_TYHMÄSTI	opt
perättäin	PCLE_TYHMÄSTI	opt
perättäisesti	PCLE_TYHMÄSTI	opt
perättömästi	PCLE_TYHMÄSTI	opt
peräänantamattomasti	PCLE_NOPEASTI	opt
pessimistisesti	PCLE_TYHMÄSTI	opt
petoksellisesti	PCLE_NOPEASTI	opt
petollisesti	PCLE_NOPEASTI	opt
petomaisesti	PCLE_NOPEASTI	opt
pettämättömästi	PCLE_TYHMÄSTI	opt
pidäkkeettömästi	PCLE_TYHMÄSTI	opt
pidättyväisesti	PCLE_TYHMÄSTI	opt
pidättyvästi	PCLE_TYHMÄSTI	opt
pieteettisesti	PCLE_TYHMÄSTI	opt
piikikkäästi	PCLE_TYHMÄSTI	opt
piilotajuisesti	PCLE_NOPEASTI	opt
piinallisesti	PCLE_NOPEASTI	opt
piireittäin	PCLE_TYHMÄSTI	opt
piittaamattomasti	PCLE_NOPEASTI	opt
pikaisesti	PCLE_NOPEASTI	opt
pikantisti	PCLE_NOPEASTI	opt
pikkumaisesti	PCLE_NOPEASTI	opt
pikkutarkasti	PCLE_NOPEASTI	opt
pikkuvanhasti	PCLE_NOPEASTI	opt
pilkallisesti	PCLE_NOPEASTI	opt
pimeästi	PCLE_TYHMÄSTI	opt
pinkoittain	PCLE_NOPEASTI	opt
pinnallisesti	PCLE_NOPEASTI	opt
pintapuolisesti	PCLE_NOPEASTI	opt
pirullisesti	PCLE_NOPEASTI	opt
pirusti	PCLE_NOPEASTI	opt
pisteliäästi	PCLE_TYHMÄSTI	opt
pitkittäin	PCLE_TYHMÄSTI	opt
pitkäjännitteisesti	PCLE_TYHMÄSTI	opt
pitkäjänteisesti	PCLE_TYHMÄSTI	opt
pitkämielisesti	PCLE_TYHMÄSTI	opt
pitkäpiimäisesti	PCLE_TYHMÄSTI	opt
pitkästi	PCLE_TYHMÄSTI	opt
pitkästyttävästi	PCLE_TYHMÄSTI	opt
pitkäveteisesti	PCLE_TYHMÄSTI	opt
piukasti	PCLE_NOPEASTI	opt
plastisesti	PCLE_NOPEASTI	opt
pneumaattisesti	PCLE_NOPEASTI	opt
-pohjaisesti	PCLE_NOPEASTI	opt
pohjalaisittain	PCLE_NOPEASTI	opt
pohjattomasti	PCLE_NOPEASTI	opt
poikamaisesti	PCLE_NOPEASTI	opt
poikittain	PCLE_NOPEASTI	opt
poikkeavasti	PCLE_NOPEASTI	opt
poikkeuksellisesti	PCLE_NOPEASTI	opt
poleemisesti	PCLE_NOPEASTI	opt
poliittisesti	PCLE_NOPEASTI	opt
polikliinisesti	PCLE_TYHMÄSTI	opt
poljennollisesti	PCLE_NOPEASTI	opt
pomminvarmasti	PCLE_NOPEASTI	opt
ponnekkaasti	PCLE_NOPEASTI	opt
pontevasti	PCLE_NOPEASTI	opt
porrasteisesti	PCLE_NOPEASTI	opt
porsasmaisesti	PCLE_NOPEASTI	opt
portaattomasti	PCLE_NOPEASTI	opt
portaittain	PCLE_NOPEASTI	opt
porvarillisesti	PCLE_NOPEASTI	opt
positiivisesti	PCLE_NOPEASTI	opt
poskettomasti	PCLE_NOPEASTI	opt
potentiaalisesti	PCLE_NOPEASTI	opt
pottumaisesti	PCLE_NOPEASTI	opt
pragmaattisesti	PCLE_NOPEASTI	opt
prameasti	PCLE_NOPEASTI	opt
primaarisesti	PCLE_NOPEASTI	opt
primaaristi	PCLE_NOPEASTI	opt
primitiivisesti	PCLE_TYHMÄSTI	opt
privaatisti	PCLE_NOPEASTI	opt
problemaattisesti	PCLE_NOPEASTI	opt
profeetallisesti	PCLE_NOPEASTI	opt
profylaktisesti	PCLE_NOPEASTI	opt
progressiivisesti	PCLE_NOPEASTI	opt
proosallisesti	PCLE_NOPEASTI	opt
prosenttisesti	PCLE_NOPEASTI	opt
prosentuaalisesti	PCLE_NOPEASTI	opt
provokatiivisesti	PCLE_NOPEASTI	opt
provokatorisesti	PCLE_NOPEASTI	opt
psykologisesti	PCLE_NOPEASTI	opt
psykoottisesti	PCLE_NOPEASTI	opt
psyykkisesti	PCLE_TYHMÄSTI	opt
puhtaasti	PCLE_NOPEASTI	opt
puisevasti	PCLE_NOPEASTI	opt
puitteissa	PCLE_KOTONA	opt
pulloittain	PCLE_NOPEASTI	opt
pulskasti	PCLE_NOPEASTI	opt
puoleensavetävästi	PCLE_TYHMÄSTI	opt
-puoleisesti	PCLE_NOPEASTI	opt
puoliautomaattisesti	PCLE_NOPEASTI	opt
puolihuolimattomasti	PCLE_NOPEASTI	opt
puolikuukausittain	PCLE_NOPEASTI	opt
puolinaisesti	PCLE_NOPEASTI	opt
puolittain	PCLE_NOPEASTI	opt
puolitunneittain	PCLE_NOPEASTI	opt
puolivillaisesti	PCLE_NOPEASTI	opt
puolivirallisesti	PCLE_NOPEASTI	opt
puolivuosittain	PCLE_NOPEASTI	opt
puolueellisesti	PCLE_NOPEASTI	opt
puolueettomasti	PCLE_NOPEASTI	opt
puolueittain	PCLE_NOPEASTI	opt
puolustuksellisesti	PCLE_NOPEASTI	opt
purevasti	PCLE_NOPEASTI	opt
puristeisesti	PCLE_NOPEASTI	opt
puristisesti	PCLE_NOPEASTI	opt
puritaanisesti	PCLE_NOPEASTI	opt
pusseittain	PCLE_NOPEASTI	opt
puuhakkaasti	PCLE_NOPEASTI	opt
puuskittain	PCLE_NOPEASTI	opt
puuskittaisesti	PCLE_NOPEASTI	opt
puutteellisesti	PCLE_NOPEASTI	opt
pyhästi	PCLE_TYHMÄSTI	opt
pykälittäin	PCLE_TYHMÄSTI	opt
pystysuorasti	PCLE_NOPEASTI	opt
pysyväisesti	PCLE_TYHMÄSTI	opt
pyyteettömästi	PCLE_TYHMÄSTI	opt
pyöreästi	PCLE_TYHMÄSTI	opt
päin	PCLE_NÄKYVIIN	opt
päittäin	PCLE_TYHMÄSTI	opt
päivittäin	PCLE_TYHMÄSTI	opt
päiväkirurgisesti	PCLE_NOPEASTI	opt
päivänselvästi	PCLE_TYHMÄSTI	opt
pälvittäin	PCLE_TYHMÄSTI	opt
pätkittäin	PCLE_TYHMÄSTI	opt
pääasiallisesti	PCLE_NOPEASTI	opt
päädyittäin	PCLE_TYHMÄSTI	opt
pääkaupunkilaisittain	PCLE_NOPEASTI	opt
pääkohdittain	PCLE_NOPEASTI	opt
päällettäin	PCLE_TYHMÄSTI	opt
päämäärättömästi	PCLE_TYHMÄSTI	opt
pääpiirteisesti	PCLE_TYHMÄSTI	opt
pääpiirteittäin	PCLE_TYHMÄSTI	opt
pääsääntöisesti	PCLE_TYHMÄSTI	opt
päättäväisesti	PCLE_TYHMÄSTI	opt
päättävästi	PCLE_TYHMÄSTI	opt
päättömästi	PCLE_TYHMÄSTI	opt
pöllösti	PCLE_TYHMÄSTI	opt
pöyhkeästi	PCLE_TYHMÄSTI	opt
raa’asti	PCLE_NOPEASTI	opt
radikaalisesti	PCLE_NOPEASTI	opt
radikaalisti	PCLE_NOPEASTI	opt
radioaktiivisesti	PCLE_NOPEASTI	opt
raflaavasti	PCLE_NOPEASTI	opt
rahallisesti	PCLE_NOPEASTI	opt
rahtivapaasti	PCLE_NOPEASTI	opt
rahvaanomaisesti	PCLE_NOPEASTI	opt
raihnaisesti	PCLE_NOPEASTI	opt
railakkaasti	PCLE_NOPEASTI	opt
raisusti	PCLE_NOPEASTI	opt
raittiisti	PCLE_NOPEASTI	opt
raivoisasti	PCLE_NOPEASTI	opt
raivokkaasti	PCLE_NOPEASTI	opt
rajallisesti	PCLE_NOPEASTI	opt
rajattomasti	PCLE_NOPEASTI	opt
rajoitetusti	PCLE_NOPEASTI	opt
rajusti	PCLE_NOPEASTI	opt
rakastettavasti	PCLE_NOPEASTI	opt
rakenteellisesti	PCLE_NOPEASTI	opt
rankasti	PCLE_NOPEASTI	opt
rasistisesti	PCLE_NOPEASTI	opt
rasittavasti	PCLE_NOPEASTI	opt
raskaasti	PCLE_NOPEASTI	opt
rationaalisesti	PCLE_NOPEASTI	opt
ratkaisevasti	PCLE_NOPEASTI	opt
rattoisasti	PCLE_NOPEASTI	opt
rauhallisesti	PCLE_NOPEASTI	opt
rauhattomasti	PCLE_NOPEASTI	opt
raukeasti	PCLE_NOPEASTI	opt
raukkamaisesti	PCLE_NOPEASTI	opt
rautaisesti	PCLE_NOPEASTI	opt
ravakasti	PCLE_NOPEASTI	opt
ravinto-opillisesti	PCLE_NOPEASTI	opt
reaaliaikaisesti	PCLE_NOPEASTI	opt
realistisesti	PCLE_NOPEASTI	opt
reflektorisesti	PCLE_NOPEASTI	opt
rehdisti	PCLE_TYHMÄSTI	opt
rehellisesti	PCLE_TYHMÄSTI	opt
rehevästi	PCLE_TYHMÄSTI	opt
rehvakkaasti	PCLE_NOPEASTI	opt
reilusti	PCLE_NOPEASTI	opt
reippaasti	PCLE_NOPEASTI	opt
remakasti	PCLE_NOPEASTI	opt
rempseästi	PCLE_TYHMÄSTI	opt
rennosti	PCLE_NOPEASTI	opt
repäisevästi	PCLE_TYHMÄSTI	opt
resitatiivisesti	PCLE_NOPEASTI	opt
reteästi	PCLE_TYHMÄSTI	opt
retorisesti	PCLE_NOPEASTI	opt
riehakkaasti	PCLE_NOPEASTI	opt
riemuisasti	PCLE_NOPEASTI	opt
riemukkaasti	PCLE_NOPEASTI	opt
riettaasti	PCLE_NOPEASTI	opt
rigoristisesti	PCLE_NOPEASTI	opt
riipaisevasti	PCLE_NOPEASTI	opt
riippumattomasti	PCLE_NOPEASTI	opt
riitaisesti	PCLE_NOPEASTI	opt
riittoisasti	PCLE_NOPEASTI	opt
riittämättömästi	PCLE_TYHMÄSTI	opt
riittävästi	PCLE_TYHMÄSTI	opt
riivatusti	PCLE_NOPEASTI	opt
rikkaasti	PCLE_NOPEASTI	opt
rikkiviisaasti	PCLE_NOPEASTI	opt
rikollisesti	PCLE_NOPEASTI	opt
rinnakkaisesti	PCLE_NOPEASTI	opt
ripeästi	PCLE_TYHMÄSTI	opt
ristikkäisesti	PCLE_TYHMÄSTI	opt
ritarillisesti	PCLE_NOPEASTI	opt
riuskasti	PCLE_NOPEASTI	opt
rivakasti	PCLE_NOPEASTI	opt
riveittäin	PCLE_TYHMÄSTI	opt
rivittäin	PCLE_TYHMÄSTI	opt
rodullisesti	PCLE_NOPEASTI	opt
rohkeasti	PCLE_NOPEASTI	opt
roimasti	PCLE_NOPEASTI	opt
roistomaisesti	PCLE_NOPEASTI	opt
romahdusmaisesti	PCLE_NOPEASTI	opt
romanttisesti	PCLE_NOPEASTI	opt
ronskisti	PCLE_NOPEASTI	opt
rosoisesti	PCLE_NOPEASTI	opt
ruhtinaallisesti	PCLE_NOPEASTI	opt
rumasti	PCLE_NOPEASTI	opt
runollisesti	PCLE_NOPEASTI	opt
runsaasti	PCLE_NOPEASTI	opt
runsaskätisesti	PCLE_TYHMÄSTI	opt
runsaslukuisesti	PCLE_NOPEASTI	opt
ruotsalaisittain	PCLE_NOPEASTI	opt
ruotsinvoittoisesti	PCLE_NOPEASTI	opt
rutiiniluonteisesti	PCLE_NOPEASTI	opt
rutiinimaisesti	PCLE_NOPEASTI	opt
rutkasti	PCLE_NOPEASTI	opt
rutosti	PCLE_NOPEASTI	opt
ruuduittain	PCLE_NOPEASTI	opt
ruumiillisesti	PCLE_NOPEASTI	opt
ryhdikkäästi	PCLE_TYHMÄSTI	opt
ryhdittömästi	PCLE_TYHMÄSTI	opt
ryhmittäin	PCLE_TYHMÄSTI	opt
rykelmittäin	PCLE_TYHMÄSTI	opt
ryppyotsaisesti	PCLE_NOPEASTI	opt
rytmikkäästi	PCLE_TYHMÄSTI	opt
rytmillisesti	PCLE_TYHMÄSTI	opt
rytmisesti	PCLE_TYHMÄSTI	opt
räikeästi	PCLE_TYHMÄSTI	opt
räiskyvästi	PCLE_TYHMÄSTI	opt
räjähdysmäisesti	PCLE_TYHMÄSTI	opt
räkäisesti	PCLE_TYHMÄSTI	opt
rämeästi	PCLE_TYHMÄSTI	opt
rämäkästi	PCLE_TYHMÄSTI	opt
rämäpäisesti	PCLE_TYHMÄSTI	opt
räväkästi	PCLE_TYHMÄSTI	opt
räävittömästi	PCLE_TYHMÄSTI	opt
rääväsuisesti	PCLE_NOPEASTI	opt
römeästi	PCLE_TYHMÄSTI	opt
röyhkeästi	PCLE_TYHMÄSTI	opt
röykkiöittäin	PCLE_TYHMÄSTI	opt
saakelisti	PCLE_NOPEASTI	opt
saakuristi	PCLE_NOPEASTI	opt
saamaristi	PCLE_NOPEASTI	opt
saatanasti	PCLE_NOPEASTI	opt
sadasti	PCLE_NOPEASTI	opt
sadistisesti	PCLE_NOPEASTI	opt
sadoittain	PCLE_NOPEASTI	opt
sadunomaisesti	PCLE_NOPEASTI	opt
saidasti	PCLE_NOPEASTI	opt
sairaalloisesti	PCLE_NOPEASTI	opt
sairaasti	PCLE_NOPEASTI	opt
salaisesti	PCLE_NOPEASTI	opt
salakavalasti	PCLE_NOPEASTI	opt
salakähmäisesti	PCLE_TYHMÄSTI	opt
salamannopeasti	PCLE_NOPEASTI	opt
salamyhkäisesti	PCLE_TYHMÄSTI	opt
salaperäisesti	PCLE_TYHMÄSTI	opt
salavihkaisesti	PCLE_NOPEASTI	opt
sallivasti	PCLE_NOPEASTI	opt
salonkikelpoisesti	PCLE_NOPEASTI	opt
samanaikaisesti	PCLE_NOPEASTI	opt
samankaltaisesti	PCLE_NOPEASTI	opt
samankeskisesti	PCLE_NOPEASTI	opt
samansuuntaisesti	PCLE_NOPEASTI	opt
samperisti	PCLE_NOPEASTI	opt
-sanaisesti	PCLE_NOPEASTI	opt
sanallisesti	PCLE_NOPEASTI	opt
sananmukaisesti	PCLE_NOPEASTI	opt
sanatarkasti	PCLE_NOPEASTI	opt
sanattomasti	PCLE_NOPEASTI	opt
sankarillisesti	PCLE_NOPEASTI	opt
sankasti	PCLE_NOPEASTI	opt
sanomattomasti	PCLE_NOPEASTI	opt
sanottavasti	PCLE_NOPEASTI	opt
sapekkaasti	PCLE_NOPEASTI	opt
sarjoittain	PCLE_NOPEASTI	opt
sarkastisesti	PCLE_NOPEASTI	opt
satakertaisesti	PCLE_NOPEASTI	opt
sataprosenttisesti	PCLE_NOPEASTI	opt
satavuotisesti	PCLE_NOPEASTI	opt
sattumanvaraisesti	PCLE_NOPEASTI	opt
sattuvasti	PCLE_NOPEASTI	opt
satunnaisesti	PCLE_NOPEASTI	opt
saumattomasti	PCLE_NOPEASTI	opt
savolaisittain	PCLE_NOPEASTI	opt
seestyneesti	PCLE_TYHMÄSTI	opt
seikkaperäisesti	PCLE_TYHMÄSTI	opt
seitsemästi	PCLE_TYHMÄSTI	opt
sekaisesti	PCLE_NOPEASTI	opt
sekapäisesti	PCLE_TYHMÄSTI	opt
sekasortoisesti	PCLE_NOPEASTI	opt
sekavasti	PCLE_NOPEASTI	opt
seksikkäästi	PCLE_TYHMÄSTI	opt
seksuaalisesti	PCLE_NOPEASTI	opt
sekularistisesti	PCLE_NOPEASTI	opt
sekundaarisesti	PCLE_NOPEASTI	opt
sekundaaristi	PCLE_NOPEASTI	opt
selektiivisesti	PCLE_TYHMÄSTI	opt
selittäin	PCLE_TYHMÄSTI	opt
selittämättömästi	PCLE_TYHMÄSTI	opt
selkeästi	PCLE_TYHMÄSTI	opt
-selkäisesti	PCLE_TYHMÄSTI	opt
selkärangattomasti	PCLE_NOPEASTI	opt
selväkielisesti	PCLE_TYHMÄSTI	opt
selvänäköisesti	PCLE_TYHMÄSTI	opt
selväpiirteisesti	PCLE_TYHMÄSTI	opt
selväsanaisesti	PCLE_NOPEASTI	opt
selvästi	PCLE_TYHMÄSTI	opt
sensijaan	PCLE_VALTAAN	opt
sensitiivisesti	PCLE_TYHMÄSTI	opt
sentimentaalisesti	PCLE_NOPEASTI	opt
separatistisesti	PCLE_NOPEASTI	opt
seremoniallisesti	PCLE_NOPEASTI	opt
sesonkiluonteisesti	PCLE_NOPEASTI	opt
setämäisesti	PCLE_TYHMÄSTI	opt
seudullisesti	PCLE_NOPEASTI	opt
seuraavasti	PCLE_NOPEASTI	opt
seuranhaluisesti	PCLE_NOPEASTI	opt
siedettävästi	PCLE_TYHMÄSTI	opt
siekailemattomasti	PCLE_NOPEASTI	opt
sielukkaasti	PCLE_NOPEASTI	opt
sielullisesti	PCLE_NOPEASTI	opt
sietämättömästi	PCLE_TYHMÄSTI	opt
sievästi	PCLE_TYHMÄSTI	opt
siirtyvästi	PCLE_TYHMÄSTI	opt
siististi	PCLE_TYHMÄSTI	opt
siivosti	PCLE_NOPEASTI	opt
siivottomasti	PCLE_NOPEASTI	opt
sikamaisesti	PCLE_NOPEASTI	opt
sikeästi	PCLE_TYHMÄSTI	opt
siksi	PCLE_LISÄKSI	opt
sileästi	PCLE_TYHMÄSTI	opt
silleen	PCLE_NÄKYVIIN	opt
silloin	PCLE_VALTAAN	opt
silmiinpistävästi	PCLE_TYHMÄSTI	opt
silminnähtävästi	PCLE_TYHMÄSTI	opt
silmittömästi	PCLE_TYHMÄSTI	opt
-silmäisesti	PCLE_TYHMÄSTI	opt
silmämääräisesti	PCLE_TYHMÄSTI	opt
siloisesti	PCLE_NOPEASTI	opt
simppelisti	PCLE_TYHMÄSTI	opt
simultaanisesti	PCLE_NOPEASTI	opt
simultaanisti	PCLE_NOPEASTI	opt
sinisilmäisesti	PCLE_TYHMÄSTI	opt
sinnikkäästi	PCLE_TYHMÄSTI	opt
sisarellisesti	PCLE_NOPEASTI	opt
sisukkaasti	PCLE_NOPEASTI	opt
sisäisesti	PCLE_TYHMÄSTI	opt
sisällisesti	PCLE_TYHMÄSTI	opt
sisäpoliittisesti	PCLE_NOPEASTI	opt
sisättäin	PCLE_TYHMÄSTI	opt
siten	PCLE_NÄKYVIIN	opt
sitkaasti	PCLE_NOPEASTI	opt
sitkeästi	PCLE_TYHMÄSTI	opt
sitovasti	PCLE_NOPEASTI	opt
siveellisesti	PCLE_TYHMÄSTI	opt
siveettömästi	PCLE_TYHMÄSTI	opt
siveästi	PCLE_TYHMÄSTI	opt
sivistymättömästi	PCLE_TYHMÄSTI	opt
sivistyneesti	PCLE_TYHMÄSTI	opt
sivuittain	PCLE_NOPEASTI	opt
sivuttain	PCLE_NOPEASTI	opt
skeptisesti	PCLE_TYHMÄSTI	opt
skitsofreenisesti	PCLE_NOPEASTI	opt
snobistisesti	PCLE_NOPEASTI	opt
soinnikkaasti	PCLE_NOPEASTI	opt
soinnillisesti	PCLE_NOPEASTI	opt
soinnittomasti	PCLE_NOPEASTI	opt
soinnukkaasti	PCLE_NOPEASTI	opt
soinnullisesti	PCLE_NOPEASTI	opt
sokeasti	PCLE_NOPEASTI	opt
solidaarisesti	PCLE_NOPEASTI	opt
somasti	PCLE_NOPEASTI	opt
sopimattomasti	PCLE_NOPEASTI	opt
sopivasti	PCLE_NOPEASTI	opt
sopuisasti	PCLE_NOPEASTI	opt
sopusointuisesti	PCLE_NOPEASTI	opt
sopusuhtaisesti	PCLE_NOPEASTI	opt
soreasti	PCLE_NOPEASTI	opt
sosiaalisesti	PCLE_NOPEASTI	opt
sotaisasti	PCLE_NOPEASTI	opt
sotaisesti	PCLE_NOPEASTI	opt
sotilaallisesti	PCLE_NOPEASTI	opt
sotilaspoliittisesti	PCLE_NOPEASTI	opt
sotkuisesti	PCLE_NOPEASTI	opt
sovinistisesti	PCLE_NOPEASTI	opt
sovinnaisesti	PCLE_NOPEASTI	opt
sovinnollisesti	PCLE_NOPEASTI	opt
sovittelevasti	PCLE_NOPEASTI	opt
spatiaalisesti	PCLE_NOPEASTI	opt
spontaanisti	PCLE_NOPEASTI	opt
sporadisesti	PCLE_NOPEASTI	opt
sporttisesti	PCLE_NOPEASTI	opt
staattisesti	PCLE_NOPEASTI	opt
stereotyyppisesti	PCLE_TYHMÄSTI	opt
steriilisti	PCLE_TYHMÄSTI	opt
stoalaisesti	PCLE_NOPEASTI	opt
strategisesti	PCLE_NOPEASTI	opt
strukturalistisesti	PCLE_NOPEASTI	opt
subjektiivisesti	PCLE_NOPEASTI	opt
suggestiivisesti	PCLE_NOPEASTI	opt
suhteellisesti	PCLE_NOPEASTI	opt
suhteellisuudentajuisesti	PCLE_NOPEASTI	opt
suhteettomasti	PCLE_NOPEASTI	opt
sujuvasti	PCLE_NOPEASTI	opt
sukkelasti	PCLE_NOPEASTI	opt
sukupuolisesti	PCLE_NOPEASTI	opt
sulavasti	PCLE_NOPEASTI	opt
suloisesti	PCLE_NOPEASTI	opt
sulokkaasti	PCLE_NOPEASTI	opt
sulosti	PCLE_NOPEASTI	opt
summaarisesti	PCLE_NOPEASTI	opt
summattomasti	PCLE_NOPEASTI	opt
summittain	PCLE_NOPEASTI	opt
summittaisesti	PCLE_NOPEASTI	opt
suomalaisesti	PCLE_NOPEASTI	opt
suomalaisittain	PCLE_NOPEASTI	opt
suonensisäisesti	PCLE_TYHMÄSTI	opt
suopeasti	PCLE_NOPEASTI	opt
suoranaisesti	PCLE_NOPEASTI	opt
suorasti	PCLE_NOPEASTI	opt
suorasukaisesti	PCLE_NOPEASTI	opt
suoraviivaisesti	PCLE_NOPEASTI	opt
suosiollisesti	PCLE_NOPEASTI	opt
suotuisasti	PCLE_NOPEASTI	opt
supisuomalaisesti	PCLE_NOPEASTI	opt
suppeasti	PCLE_NOPEASTI	opt
surkeasti	PCLE_NOPEASTI	opt
surullisesti	PCLE_NOPEASTI	opt
surumielisesti	PCLE_TYHMÄSTI	opt
suruttomasti	PCLE_NOPEASTI	opt
sutjakasti	PCLE_NOPEASTI	opt
suulaasti	PCLE_NOPEASTI	opt
suullisesti	PCLE_NOPEASTI	opt
suunnattomasti	PCLE_NOPEASTI	opt
suunnilleen	PCLE_VALTAAN	opt
suunnitelmallisesti	PCLE_NOPEASTI	opt
suunnittelemattomasti	PCLE_NOPEASTI	opt
suuntaisesti	PCLE_NOPEASTI	opt
suurellisesti	PCLE_TYHMÄSTI	opt
suurenmoisesti	PCLE_NOPEASTI	opt
suuresti	PCLE_NOPEASTI	opt
suurieleisesti	PCLE_TYHMÄSTI	opt
suurisanaisesti	PCLE_NOPEASTI	opt
suurisuisesti	PCLE_NOPEASTI	opt
suurisuuntaisesti	PCLE_NOPEASTI	opt
suuriäänisesti	PCLE_TYHMÄSTI	opt
suurpiirteisesti	PCLE_TYHMÄSTI	opt
suvaitsemattomasti	PCLE_NOPEASTI	opt
suvaitsevaisesti	PCLE_NOPEASTI	opt
suvaitsevasti	PCLE_NOPEASTI	opt
suvereenisesti	PCLE_NOPEASTI	opt
suvereenisti	PCLE_NOPEASTI	opt
suvuittain	PCLE_NOPEASTI	opt
suvullisesti	PCLE_NOPEASTI	opt
suvuttomasti	PCLE_NOPEASTI	opt
sydämellisesti	PCLE_TYHMÄSTI	opt
sydämettömästi	PCLE_TYHMÄSTI	opt
sylittäin	PCLE_TYHMÄSTI	opt
symbioottisesti	PCLE_NOPEASTI	opt
symbolisesti	PCLE_NOPEASTI	opt
symmetrisesti	PCLE_TYHMÄSTI	opt
sympaattisesti	PCLE_NOPEASTI	opt
synkästi	PCLE_TYHMÄSTI	opt
synnillisesti	PCLE_TYHMÄSTI	opt
synnynnäisesti	PCLE_TYHMÄSTI	opt
synteettisesti	PCLE_TYHMÄSTI	opt
syntisesti	PCLE_TYHMÄSTI	opt
-syntyisesti	PCLE_TYHMÄSTI	opt
syrjittäin	PCLE_TYHMÄSTI	opt
systeemisesti	PCLE_TYHMÄSTI	opt
systemaattisesti	PCLE_NOPEASTI	opt
sysäyksittäin	PCLE_TYHMÄSTI	opt
syvällisesti	PCLE_TYHMÄSTI	opt
syvästi	PCLE_TYHMÄSTI	opt
syyttömästi	PCLE_TYHMÄSTI	opt
sähköisesti	PCLE_TYHMÄSTI	opt
sähäkästi	PCLE_TYHMÄSTI	opt
säkeittäin	PCLE_TYHMÄSTI	opt
säntillisesti	PCLE_TYHMÄSTI	opt
särmikkäästi	PCLE_TYHMÄSTI	opt
säteittäin	PCLE_TYHMÄSTI	opt
säteittäisesti	PCLE_TYHMÄSTI	opt
sävyisesti	PCLE_TYHMÄSTI	opt
sävyisästi	PCLE_TYHMÄSTI	opt
säyseästi	PCLE_TYHMÄSTI	opt
säädyllisesti	PCLE_TYHMÄSTI	opt
säädyttömästi	PCLE_TYHMÄSTI	opt
säälimättömästi	PCLE_TYHMÄSTI	opt
säällisesti	PCLE_TYHMÄSTI	opt
säännöllisesti	PCLE_TYHMÄSTI	opt
säännönmukaisesti	PCLE_NOPEASTI	opt
säännöttömästi	PCLE_TYHMÄSTI	opt
säästeliäästi	PCLE_TYHMÄSTI	opt
säästäväisesti	PCLE_TYHMÄSTI	opt
-säätöisesti	PCLE_TYHMÄSTI	opt
söpösti	PCLE_TYHMÄSTI	opt
söötisti	PCLE_TYHMÄSTI	opt
taajasti	PCLE_NOPEASTI	opt
taantumuksellisesti	PCLE_NOPEASTI	opt
taatusti	PCLE_NOPEASTI	opt
tahallisesti	PCLE_NOPEASTI	opt
tahattomasti	PCLE_NOPEASTI	opt
tahdikkaasti	PCLE_NOPEASTI	opt
tahdittomasti	PCLE_NOPEASTI	opt
tahmeasti	PCLE_NOPEASTI	opt
taianomaisesti	PCLE_NOPEASTI	opt
taidehistoriallisesti	PCLE_NOPEASTI	opt
taidokkaasti	PCLE_NOPEASTI	opt
taidollisesti	PCLE_NOPEASTI	opt
taidottomasti	PCLE_NOPEASTI	opt
taikauskoisesti	PCLE_NOPEASTI	opt
taipuisasti	PCLE_NOPEASTI	opt
taitamattomasti	PCLE_NOPEASTI	opt
taitavasti	PCLE_NOPEASTI	opt
taiteellisesti	PCLE_NOPEASTI	opt
taiturillisesti	PCLE_NOPEASTI	opt
taiturimaisesti	PCLE_NOPEASTI	opt
taivaallisesti	PCLE_NOPEASTI	opt
tajuisesti	PCLE_NOPEASTI	opt
tajuttomasti	PCLE_NOPEASTI	opt
takapajuisesti	PCLE_NOPEASTI	opt
takaperoisesti	PCLE_NOPEASTI	opt
takkuisesti	PCLE_NOPEASTI	opt
taktisesti	PCLE_NOPEASTI	opt
taloudellisesti	PCLE_NOPEASTI	opt
tanakasti	PCLE_NOPEASTI	opt
tanttamaisesti	PCLE_NOPEASTI	opt
tapaisesti	PCLE_NOPEASTI	opt
tapaturmaisesti	PCLE_NOPEASTI	opt
tapauksittain	PCLE_NOPEASTI	opt
tappiollisesti	PCLE_NOPEASTI	opt
tarkalleen	PCLE_VALTAAN	opt
tarkasti	PCLE_NOPEASTI	opt
tarkkaamattomasti	PCLE_NOPEASTI	opt
tarkkaavaisesti	PCLE_NOPEASTI	opt
tarkkaavasti	PCLE_NOPEASTI	opt
tarkkakätisesti	PCLE_TYHMÄSTI	opt
tarkkanäköisesti	PCLE_TYHMÄSTI	opt
tarkkasilmäisesti	PCLE_TYHMÄSTI	opt
tarkoituksellisesti	PCLE_NOPEASTI	opt
tarkoituksenmukaisesti	PCLE_NOPEASTI	opt
tarkoituksettomasti	PCLE_NOPEASTI	opt
tarkoitushakuisesti	PCLE_NOPEASTI	opt
tarmokkaasti	PCLE_NOPEASTI	opt
tarpeettomasti	PCLE_NOPEASTI	opt
tarunomaisesti	PCLE_NOPEASTI	opt
tasa-arvoisesti	PCLE_NOPEASTI	opt
tasaisesti	PCLE_NOPEASTI	opt
tasajatkuisesti	PCLE_NOPEASTI	opt
tasamittaisesti	PCLE_NOPEASTI	opt
tasapainoisesti	PCLE_NOPEASTI	opt
tasapainottomasti	PCLE_NOPEASTI	opt
tasapaksusti	PCLE_NOPEASTI	opt
tasapuolisesti	PCLE_NOPEASTI	opt
tasapäisesti	PCLE_TYHMÄSTI	opt
tasasuhtaisesti	PCLE_NOPEASTI	opt
tasatahtisesti	PCLE_NOPEASTI	opt
tasavaltaisesti	PCLE_NOPEASTI	opt
tasaveroisesti	PCLE_NOPEASTI	opt
tasavertaisesti	PCLE_NOPEASTI	opt
tasaväkisesti	PCLE_TYHMÄSTI	opt
tauottomasti	PCLE_NOPEASTI	opt
tautisesti	PCLE_NOPEASTI	opt
tavallaan	PCLE_VALTAAN	opt
tavallisesti	PCLE_NOPEASTI	opt
tavanmukaisesti	PCLE_NOPEASTI	opt
tavanomaisesti	PCLE_NOPEASTI	opt
tavattomasti	PCLE_NOPEASTI	opt
tavoitteellisesti	PCLE_NOPEASTI	opt
teatraalisesti	PCLE_NOPEASTI	opt
teennäisesti	PCLE_TYHMÄSTI	opt
teeskentelemättömästi	PCLE_TYHMÄSTI	opt
tehdasmaisesti	PCLE_NOPEASTI	opt
-tehoisesti	PCLE_NOPEASTI	opt
tehokkaasti	PCLE_NOPEASTI	opt
tehottomasti	PCLE_NOPEASTI	opt
teikäläisittäin	PCLE_TYHMÄSTI	opt
teknisesti	PCLE_TYHMÄSTI	opt
tekohurskaasti	PCLE_NOPEASTI	opt
-tekoisesti	PCLE_NOPEASTI	opt
tekopyhästi	PCLE_TYHMÄSTI	opt
teleskooppisesti	PCLE_NOPEASTI	opt
teollisesti	PCLE_NOPEASTI	opt
teoreettisesti	PCLE_NOPEASTI	opt
terhakasti	PCLE_NOPEASTI	opt
terhakkaasti	PCLE_NOPEASTI	opt
terveellisesti	PCLE_TYHMÄSTI	opt
terveesti	PCLE_TYHMÄSTI	opt
tervehenkisesti	PCLE_TYHMÄSTI	opt
teräväjärkisesti	PCLE_TYHMÄSTI	opt
teräväkatseisesti	PCLE_NOPEASTI	opt
teräväkielisesti	PCLE_TYHMÄSTI	opt
terävänäköisesti	PCLE_TYHMÄSTI	opt
teräväsanaisesti	PCLE_NOPEASTI	opt
terävästi	PCLE_TYHMÄSTI	opt
terävä-älyisesti	PCLE_TYHMÄSTI	opt
tiedottomasti	PCLE_NOPEASTI	opt
tieteellisesti	PCLE_TYHMÄSTI	opt
tietoisesti	PCLE_NOPEASTI	opt
tietokoneavusteisesti	PCLE_NOPEASTI	opt
tietopuolisesti	PCLE_NOPEASTI	opt
tietoteknisesti	PCLE_TYHMÄSTI	opt
tiettävästi	PCLE_TYHMÄSTI	opt
tietysti	PCLE_TYHMÄSTI	opt
tietävästi	PCLE_TYHMÄSTI	opt
tiheästi	PCLE_TYHMÄSTI	opt
tiiviisti	PCLE_TYHMÄSTI	opt
tilapäisesti	PCLE_TYHMÄSTI	opt
tilastollisesti	PCLE_NOPEASTI	opt
tilastotieteellisesti	PCLE_NOPEASTI	opt
tilavasti	PCLE_NOPEASTI	opt
tinkimättömästi	PCLE_TYHMÄSTI	opt
tipoittain	PCLE_NOPEASTI	opt
tiukasti	PCLE_NOPEASTI	opt
tiukkapipoisesti	PCLE_NOPEASTI	opt
todella	PCLE_KOTONA	opt
todellisesti	PCLE_NOPEASTI	opt
todellisuudentajuisesti	PCLE_NOPEASTI	opt
todenmukaisesti	PCLE_NOPEASTI	opt
todennäköisesti	PCLE_TYHMÄSTI	opt
todesti	PCLE_NOPEASTI	opt
todisteellisesti	PCLE_NOPEASTI	opt
toimekkaasti	PCLE_NOPEASTI	opt
toimeliaasti	PCLE_NOPEASTI	opt
toisinsanoen	PCLE_VALTAAN	opt
toissijaisesti	PCLE_NOPEASTI	opt
toistuvasti	PCLE_NOPEASTI	opt
toiveikkaasti	PCLE_NOPEASTI	opt
toivottavasti	PCLE_NOPEASTI	opt
toivottomasti	PCLE_NOPEASTI	opt
tolerantisti	PCLE_NOPEASTI	opt
tolkuttomasti	PCLE_NOPEASTI	opt
tomerasti	PCLE_NOPEASTI	opt
tonaalisesti	PCLE_NOPEASTI	opt
tonneittain	PCLE_NOPEASTI	opt
topakasti	PCLE_NOPEASTI	opt
topografisesti	PCLE_NOPEASTI	opt
torjuvasti	PCLE_NOPEASTI	opt
tosiasiallisesti	PCLE_NOPEASTI	opt
tosikkomaisesti	PCLE_NOPEASTI	opt
tota	PCLE_KOTONA	opt
totaalisesti	PCLE_NOPEASTI	opt
totalitaarisesti	PCLE_NOPEASTI	opt
totisesti	PCLE_NOPEASTI	opt
tottelemattomasti	PCLE_NOPEASTI	opt
tottelevaisesti	PCLE_NOPEASTI	opt
totuudellisesti	PCLE_NOPEASTI	opt
totuudenmukaisesti	PCLE_NOPEASTI	opt
touhukkaasti	PCLE_NOPEASTI	opt
toverillisesti	PCLE_NOPEASTI	opt
traagisesti	PCLE_NOPEASTI	opt
traditionaalisesti	PCLE_NOPEASTI	opt
trendikkäästi	PCLE_TYHMÄSTI	opt
triviaalisti	PCLE_NOPEASTI	opt
tuhannesti	PCLE_NOPEASTI	opt
tuhansittain	PCLE_NOPEASTI	opt
tuhatkertaisesti	PCLE_NOPEASTI	opt
tuhdisti	PCLE_NOPEASTI	opt
tuhmasti	PCLE_NOPEASTI	opt
tuhoisasti	PCLE_NOPEASTI	opt
tuhottomasti	PCLE_NOPEASTI	opt
tuhruisesti	PCLE_NOPEASTI	opt
tuikeasti	PCLE_NOPEASTI	opt
tuimasti	PCLE_NOPEASTI	opt
tuittupäisesti	PCLE_TYHMÄSTI	opt
tukalasti	PCLE_NOPEASTI	opt
tukevasti	PCLE_NOPEASTI	opt
tukkoisesti	PCLE_NOPEASTI	opt
tukuittain	PCLE_NOPEASTI	opt
tulisesti	PCLE_NOPEASTI	opt
tulkinnanvaraisesti	PCLE_NOPEASTI	opt
tullittomasti	PCLE_NOPEASTI	opt
tuloksekkaasti	PCLE_NOPEASTI	opt
tuloksellisesti	PCLE_NOPEASTI	opt
tungettelevasti	PCLE_NOPEASTI	opt
tunkeilevasti	PCLE_NOPEASTI	opt
tunneittain	PCLE_NOPEASTI	opt
tunnekylläisesti	PCLE_TYHMÄSTI	opt
tunneperäisesti	PCLE_TYHMÄSTI	opt
tunnetusti	PCLE_NOPEASTI	opt
tunnokkaasti	PCLE_NOPEASTI	opt
tunnollisesti	PCLE_NOPEASTI	opt
tunnontarkasti	PCLE_NOPEASTI	opt
tunnottomasti	PCLE_NOPEASTI	opt
tunnustuksellisesti	PCLE_NOPEASTI	opt
tunteellisesti	PCLE_NOPEASTI	opt
tunteenomaisesti	PCLE_NOPEASTI	opt
tunteettomasti	PCLE_NOPEASTI	opt
tunteikkaasti	PCLE_NOPEASTI	opt
-tunteisesti	PCLE_NOPEASTI	opt
-tuntoisesti	PCLE_NOPEASTI	opt
tuntuisesti	PCLE_NOPEASTI	opt
tuntuvasti	PCLE_NOPEASTI	opt
tuopeittain	PCLE_NOPEASTI	opt
tuoreesti	PCLE_NOPEASTI	opt
tuottamattomasti	PCLE_NOPEASTI	opt
tuottamuksellisesti	PCLE_NOPEASTI	opt
tuottavasti	PCLE_NOPEASTI	opt
tuotteliaasti	PCLE_NOPEASTI	opt
tuottoisasti	PCLE_NOPEASTI	opt
tuplasti	PCLE_NOPEASTI	opt
turhamaisesti	PCLE_NOPEASTI	opt
turhanpäiväisesti	PCLE_TYHMÄSTI	opt
turhantarkasti	PCLE_NOPEASTI	opt
turkasesti	PCLE_NOPEASTI	opt
turmiollisesti	PCLE_NOPEASTI	opt
turvallisesti	PCLE_NOPEASTI	opt
tusinoittain	PCLE_NOPEASTI	opt
tuskaisasti	PCLE_NOPEASTI	opt
tuskaisesti	PCLE_NOPEASTI	opt
tuskallisesti	PCLE_NOPEASTI	opt
tuskattomasti	PCLE_NOPEASTI	opt
tutkivasti	PCLE_NOPEASTI	opt
tuttavallisesti	PCLE_NOPEASTI	opt
tutunomaisesti	PCLE_NOPEASTI	opt
tutusti	PCLE_NOPEASTI	opt
tuulenpitävästi	PCLE_TYHMÄSTI	opt
tyhjentävästi	PCLE_TYHMÄSTI	opt
tyhjänpäiväisesti	PCLE_TYHMÄSTI	opt
tyhmänrohkeasti	PCLE_NOPEASTI	opt
tyhmästi	PCLE_TYHMÄSTI	opt
tylpästi	PCLE_TYHMÄSTI	opt
tylysti	PCLE_TYHMÄSTI	opt
tympeästi	PCLE_TYHMÄSTI	opt
tynnyreittäin	PCLE_TYHMÄSTI	opt
typerästi	PCLE_TYHMÄSTI	opt
tyrannimaisesti	PCLE_NOPEASTI	opt
tyttömäisesti	PCLE_TYHMÄSTI	opt
tyydyttävästi	PCLE_TYHMÄSTI	opt
tyylikkäästi	PCLE_TYHMÄSTI	opt
tyylillisesti	PCLE_TYHMÄSTI	opt
tyylinmukaisesti	PCLE_NOPEASTI	opt
tyylisesti	PCLE_TYHMÄSTI	opt
tyylittömästi	PCLE_TYHMÄSTI	opt
tyynesti	PCLE_TYHMÄSTI	opt
tyypeittäin	PCLE_TYHMÄSTI	opt
tyypillisesti	PCLE_TYHMÄSTI	opt
tyytymättömästi	PCLE_TYHMÄSTI	opt
tyytyväisesti	PCLE_TYHMÄSTI	opt
työläästi	PCLE_TYHMÄSTI	opt
tähdellisesti	PCLE_TYHMÄSTI	opt
tähysteisesti	PCLE_TYHMÄSTI	opt
täpärästi	PCLE_TYHMÄSTI	opt
tärkeilevästi	PCLE_TYHMÄSTI	opt
tärkeästi	PCLE_TYHMÄSTI	opt
täsmällisesti	PCLE_TYHMÄSTI	opt
tätimäisesti	PCLE_TYHMÄSTI	opt
täydellisesti	PCLE_TYHMÄSTI	opt
täydesti	PCLE_TYHMÄSTI	opt
täysilukuisesti	PCLE_NOPEASTI	opt
täysimittaisesti	PCLE_NOPEASTI	opt
täysimääräisesti	PCLE_TYHMÄSTI	opt
täysipainoisesti	PCLE_NOPEASTI	opt
täysipäiväisesti	PCLE_TYHMÄSTI	opt
täysitehoisesti	PCLE_NOPEASTI	opt
täysivaltaisesti	PCLE_NOPEASTI	opt
täysivoimaisesti	PCLE_NOPEASTI	opt
täyspäisesti	PCLE_TYHMÄSTI	opt
täyspäiväisesti	PCLE_TYHMÄSTI	opt
täyteläisesti	PCLE_TYHMÄSTI	opt
töhryisesti	PCLE_TYHMÄSTI	opt
tökerösti	PCLE_TYHMÄSTI	opt
törkeästi	PCLE_TYHMÄSTI	opt
törkyisesti	PCLE_TYHMÄSTI	opt
töykeästi	PCLE_TYHMÄSTI	opt
uhkaavasti	PCLE_NOPEASTI	opt
uhkarohkeasti	PCLE_NOPEASTI	opt
uhkeasti	PCLE_NOPEASTI	opt
uhmakkaasti	PCLE_NOPEASTI	opt
uhmamielisesti	PCLE_TYHMÄSTI	opt
uhmapäisesti	PCLE_TYHMÄSTI	opt
uhrautuvasti	PCLE_NOPEASTI	opt
ujostelemattomasti	PCLE_NOPEASTI	opt
ujosti	PCLE_NOPEASTI	opt
uljaasti	PCLE_NOPEASTI	opt
ulkoisesti	PCLE_NOPEASTI	opt
ulkokohtaisesti	PCLE_NOPEASTI	opt
ulkokultaisesti	PCLE_NOPEASTI	opt
ulkonaisesti	PCLE_NOPEASTI	opt
ulkopoliittisesti	PCLE_NOPEASTI	opt
umpimielisesti	PCLE_TYHMÄSTI	opt
umpimähkäisesti	PCLE_TYHMÄSTI	opt
umpinaisesti	PCLE_NOPEASTI	opt
uneliaasti	PCLE_NOPEASTI	opt
unisesti	PCLE_NOPEASTI	opt
unohtumattomasti	PCLE_NOPEASTI	opt
upeasti	PCLE_NOPEASTI	opt
uppiniskaisesti	PCLE_NOPEASTI	opt
uraauurtavasti	PCLE_NOPEASTI	opt
urbaanisesti	PCLE_NOPEASTI	opt
urbaanisti	PCLE_NOPEASTI	opt
urheasti	PCLE_NOPEASTI	opt
urhoollisesti	PCLE_NOPEASTI	opt
useasti	PCLE_NOPEASTI	opt
uskaliaasti	PCLE_NOPEASTI	opt
-uskoisesti	PCLE_NOPEASTI	opt
uskollisesti	PCLE_NOPEASTI	opt
uskomattomasti	PCLE_NOPEASTI	opt
uskonnollisesti	PCLE_NOPEASTI	opt
uskottavasti	PCLE_NOPEASTI	opt
uteliaasti	PCLE_NOPEASTI	opt
utopistisesti	PCLE_NOPEASTI	opt
uupumattomasti	PCLE_NOPEASTI	opt
uusrahvaanomaisesti	PCLE_NOPEASTI	opt
uutterasti	PCLE_NOPEASTI	opt
vaan	PCLE_VAAN	opt
vaarallisesti	PCLE_NOPEASTI	opt
vaateliaasti	PCLE_NOPEASTI	opt
vaatimattomasti	PCLE_NOPEASTI	opt
vaativasti	PCLE_NOPEASTI	opt
vahingollisesti	PCLE_NOPEASTI	opt
vahingoniloisesti	PCLE_NOPEASTI	opt
vahvasti	PCLE_NOPEASTI	opt
vaiheittain	PCLE_NOPEASTI	opt
vaiheittaisesti	PCLE_NOPEASTI	opt
vaihtoehtoisesti	PCLE_NOPEASTI	opt
vaikeaselkoisesti	PCLE_NOPEASTI	opt
vaikeasti	PCLE_NOPEASTI	opt
vaikeatajuisesti	PCLE_NOPEASTI	opt
vaikka	PCLE_KOTONA	opt
vaikuttavasti	PCLE_NOPEASTI	opt
-vaikutteisesti	PCLE_NOPEASTI	opt
vaillinaisesti	PCLE_NOPEASTI	opt
-vaistoisesti	PCLE_NOPEASTI	opt
vaistomaisesti	PCLE_NOPEASTI	opt
vaistonvaraisesti	PCLE_NOPEASTI	opt
vaisusti	PCLE_NOPEASTI	opt
vaiteliaasti	PCLE_NOPEASTI	opt
vaitonaisesti	PCLE_NOPEASTI	opt
vaivaisesti	PCLE_NOPEASTI	opt
vaivalloisesti	PCLE_NOPEASTI	opt
vaivattomasti	PCLE_NOPEASTI	opt
vajaatehoisesti	PCLE_NOPEASTI	opt
vajanaisesti	PCLE_NOPEASTI	opt
vajavaisesti	PCLE_NOPEASTI	opt
vakaasti	PCLE_NOPEASTI	opt
vakaumuksellisesti	PCLE_NOPEASTI	opt
vakavasti	PCLE_NOPEASTI	opt
vakinaisesti	PCLE_NOPEASTI	opt
vakituisesti	PCLE_NOPEASTI	opt
vakuuttavasti	PCLE_NOPEASTI	opt
valaehtoisesti	PCLE_NOPEASTI	opt
valheellisesti	PCLE_NOPEASTI	opt
valinnaisesti	PCLE_NOPEASTI	opt
valitettavasti	PCLE_NOPEASTI	opt
valjusti	PCLE_NOPEASTI	opt
vallankumouksellisesti	PCLE_NOPEASTI	opt
vallattomasti	PCLE_NOPEASTI	opt
vallitsevasti	PCLE_NOPEASTI	opt
valloittavasti	PCLE_NOPEASTI	opt
valmistavasti	PCLE_NOPEASTI	opt
valoisasti	PCLE_NOPEASTI	opt
valokuvauksellisesti	PCLE_NOPEASTI	opt
valossa	PCLE_KOTONA	opt
valppaasti	PCLE_NOPEASTI	opt
valtaisasti	PCLE_NOPEASTI	opt
-valtaisesti	PCLE_NOPEASTI	opt
valtakunnallisesti	PCLE_NOPEASTI	opt
valtavasti	PCLE_NOPEASTI	opt
valtioviisaasti	PCLE_NOPEASTI	opt
valtoimesti	PCLE_NOPEASTI	opt
vanhahtavasti	PCLE_NOPEASTI	opt
vanhanaikaisesti	PCLE_NOPEASTI	opt
vanhoillisesti	PCLE_NOPEASTI	opt
vankasti	PCLE_NOPEASTI	opt
vankkumattomasti	PCLE_NOPEASTI	opt
vapaaehtoisesti	PCLE_NOPEASTI	opt
vapaamielisesti	PCLE_TYHMÄSTI	opt
vapaamuotoisesti	PCLE_NOPEASTI	opt
vapaasti	PCLE_NOPEASTI	opt
-varaisesti	PCLE_NOPEASTI	opt
varakkaasti	PCLE_NOPEASTI	opt
varauksellisesti	PCLE_NOPEASTI	opt
varauksettomasti	PCLE_NOPEASTI	opt
varmasti	PCLE_NOPEASTI	opt
varomattomasti	PCLE_NOPEASTI	opt
varovaisesti	PCLE_NOPEASTI	opt
varovasti	PCLE_NOPEASTI	opt
varsinaisesti	PCLE_NOPEASTI	opt
vasemmistolaisesti	PCLE_NOPEASTI	opt
vasenkätisesti	PCLE_TYHMÄSTI	opt
vasituisesti	PCLE_NOPEASTI	opt
vastaanottavaisesti	PCLE_NOPEASTI	opt
vastaanottavasti	PCLE_NOPEASTI	opt
vastaansanomattomasti	PCLE_NOPEASTI	opt
vastaavanlaisesti	PCLE_NOPEASTI	opt
vastaavasti	PCLE_NOPEASTI	opt
vastahakoisesti	PCLE_NOPEASTI	opt
vastaisesti	PCLE_NOPEASTI	opt
vastakkaisesti	PCLE_NOPEASTI	opt
vastavuoroisesti	PCLE_NOPEASTI	opt
vastenmielisesti	PCLE_NOPEASTI	opt
vastentahtoisesti	PCLE_NOPEASTI	opt
-vastuisesti	PCLE_NOPEASTI	opt
vastuksellisesti	PCLE_NOPEASTI	opt
vastustamattomasti	PCLE_NOPEASTI	opt
vastustushaluisesti	PCLE_NOPEASTI	opt
vastuullisesti	PCLE_NOPEASTI	opt
vastuuntunnottomasti	PCLE_NOPEASTI	opt
vastuuntuntoisesti	PCLE_NOPEASTI	opt
vastuuttomasti	PCLE_NOPEASTI	opt
vauhdikkaasti	PCLE_NOPEASTI	opt
vauraasti	PCLE_NOPEASTI	opt
vedenpitävästi	PCLE_TYHMÄSTI	opt
veikeästi	PCLE_TYHMÄSTI	opt
veitikkamaisesti	PCLE_NOPEASTI	opt
veljellisesti	PCLE_TYHMÄSTI	opt
velmusti	PCLE_NOPEASTI	opt
veltosti	PCLE_NOPEASTI	opt
velvollisuudentuntoisesti	PCLE_NOPEASTI	opt
verenhimoisesti	PCLE_NOPEASTI	opt
verisesti	PCLE_TYHMÄSTI	opt
verkkaisasti	PCLE_NOPEASTI	opt
verkkaisesti	PCLE_NOPEASTI	opt
veroisesti	PCLE_NOPEASTI	opt
verotuksellisesti	PCLE_NOPEASTI	opt
verrannollisesti	PCLE_NOPEASTI	opt
verrattain	PCLE_NOPEASTI	opt
verrattomasti	PCLE_NOPEASTI	opt
verrattuna	PCLE_KOTONA	opt
vertaisesti	PCLE_NOPEASTI	opt
vertauskuvallisesti	PCLE_NOPEASTI	opt
vetelästi	PCLE_TYHMÄSTI	opt
vetävästi	PCLE_TYHMÄSTI	opt
viattomasti	PCLE_NOPEASTI	opt
viehkeästi	PCLE_TYHMÄSTI	opt
viehkosti	PCLE_NOPEASTI	opt
viehättävästi	PCLE_TYHMÄSTI	opt
viekkaasti	PCLE_NOPEASTI	opt
vienosti	PCLE_NOPEASTI	opt
vieraanvaraisesti	PCLE_NOPEASTI	opt
vieraanvoittoisesti	PCLE_NOPEASTI	opt
vierettäin	PCLE_TYHMÄSTI	opt
viettelevästi	PCLE_TYHMÄSTI	opt
vietävästi	PCLE_TYHMÄSTI	opt
vihaisesti	PCLE_NOPEASTI	opt
vihamielisesti	PCLE_NOPEASTI	opt
vihdoin	PCLE_VALTAAN	opt
viheliäisesti	PCLE_TYHMÄSTI	opt
vihkoittain	PCLE_NOPEASTI	opt
vihoittain	PCLE_NOPEASTI	opt
viidesti	PCLE_TYHMÄSTI	opt
viihteellisesti	PCLE_TYHMÄSTI	opt
viihtyisästi	PCLE_TYHMÄSTI	opt
viikoittain	PCLE_NOPEASTI	opt
viileästi	PCLE_TYHMÄSTI	opt
viisaasti	PCLE_NOPEASTI	opt
viistosti	PCLE_NOPEASTI	opt
viitseliäästi	PCLE_TYHMÄSTI	opt
viitteellisesti	PCLE_TYHMÄSTI	opt
-viivaisesti	PCLE_NOPEASTI	opt
viivasuorasti	PCLE_NOPEASTI	opt
vikkelästi	PCLE_TYHMÄSTI	opt
viktoriaanisesti	PCLE_NOPEASTI	opt
vilkkaasti	PCLE_NOPEASTI	opt
villisti	PCLE_TYHMÄSTI	opt
vilpittömästi	PCLE_TYHMÄSTI	opt
vilpoisasti	PCLE_NOPEASTI	opt
vilpoisesti	PCLE_NOPEASTI	opt
vimmaisesti	PCLE_NOPEASTI	opt
vimmatusti	PCLE_NOPEASTI	opt
vinhasti	PCLE_NOPEASTI	opt
vinkeästi	PCLE_TYHMÄSTI	opt
vinoittain	PCLE_NOPEASTI	opt
vinosti	PCLE_NOPEASTI	opt
vinottain	PCLE_NOPEASTI	opt
virallisesti	PCLE_NOPEASTI	opt
vireästi	PCLE_TYHMÄSTI	opt
virheellisesti	PCLE_TYHMÄSTI	opt
virkaintoisesti	PCLE_NOPEASTI	opt
virkavaltaisesti	PCLE_NOPEASTI	opt
virkeästi	PCLE_TYHMÄSTI	opt
virolaisittain	PCLE_NOPEASTI	opt
vissisti	PCLE_TYHMÄSTI	opt
visuaalisesti	PCLE_NOPEASTI	opt
visusti	PCLE_NOPEASTI	opt
vitaalisesti	PCLE_NOPEASTI	opt
vitsikkäästi	PCLE_TYHMÄSTI	opt
vittumaisesti	PCLE_NOPEASTI	opt
viuhkamaisesti	PCLE_NOPEASTI	opt
vivahteettomasti	PCLE_NOPEASTI	opt
vivahteikkaasti	PCLE_NOPEASTI	opt
-voimaisesti	PCLE_NOPEASTI	opt
voimakkaasti	PCLE_NOPEASTI	opt
voimallisesti	PCLE_NOPEASTI	opt
voimaperäisesti	PCLE_TYHMÄSTI	opt
voimattomasti	PCLE_NOPEASTI	opt
voitokkaasti	PCLE_NOPEASTI	opt
voitollisesti	PCLE_NOPEASTI	opt
voitonriemuisesti	PCLE_NOPEASTI	opt
voitonvarmasti	PCLE_NOPEASTI	opt
voittoisasti	PCLE_NOPEASTI	opt
-voittoisesti	PCLE_NOPEASTI	opt
voittopuolisesti	PCLE_NOPEASTI	opt
vuodenajoittain	PCLE_NOPEASTI	opt
vuokseen	PCLE_NOPEASTI	opt
vuoksemme	PCLE_NOPEASTI	opt
vuokseni	PCLE_NOPEASTI	opt
vuoksenne	PCLE_NOPEASTI	opt
vuoksensa	PCLE_NOPEASTI	opt
vuoksesi	PCLE_NOPEASTI	opt
vuoksi	PCLE_VUOKSI	opt
vuolaasti	PCLE_NOPEASTI	opt
vuolassanaisesti	PCLE_NOPEASTI	opt
vuorenvarmasti	PCLE_NOPEASTI	opt
vuoroittain	PCLE_NOPEASTI	opt
vuorokausittain	PCLE_NOPEASTI	opt
vuorovaikutteisesti	PCLE_NOPEASTI	opt
vuosiluokittain	PCLE_NOPEASTI	opt
vuosineljänneksittäin	PCLE_TYHMÄSTI	opt
vuosittain	PCLE_NOPEASTI	opt
vähittäin	PCLE_TYHMÄSTI	opt
vähäeleisesti	PCLE_TYHMÄSTI	opt
vähäilmeisesti	PCLE_TYHMÄSTI	opt
vähälukuisesti	PCLE_NOPEASTI	opt
väistyvästi	PCLE_TYHMÄSTI	opt
väistämättömästi	PCLE_TYHMÄSTI	opt
väkevästi	PCLE_TYHMÄSTI	opt
väkinäisesti	PCLE_TYHMÄSTI	opt
väkivallattomasti	PCLE_NOPEASTI	opt
väkivaltaisesti	PCLE_NOPEASTI	opt
väliaikaisesti	PCLE_NOPEASTI	opt
välillisesti	PCLE_TYHMÄSTI	opt
välinpitämättömästi	PCLE_TYHMÄSTI	opt
välittömästi	PCLE_TYHMÄSTI	opt
väljästi	PCLE_TYHMÄSTI	opt
välttämättömästi	PCLE_TYHMÄSTI	opt
välähdyksittäin	PCLE_TYHMÄSTI	opt
väläyksittäin	PCLE_TYHMÄSTI	opt
värikkäästi	PCLE_TYHMÄSTI	opt
värikylläisesti	PCLE_TYHMÄSTI	opt
värittömästi	PCLE_TYHMÄSTI	opt
väsymättömästi	PCLE_TYHMÄSTI	opt
väsyneesti	PCLE_TYHMÄSTI	opt
vääjäämättömästi	PCLE_TYHMÄSTI	opt
väärämielisesti	PCLE_TYHMÄSTI	opt
yhdenmukaisesti	PCLE_NOPEASTI	opt
yhdesti	PCLE_TYHMÄSTI	opt
yhtaikaisesti	PCLE_NOPEASTI	opt
yhteisesti	PCLE_TYHMÄSTI	opt
yhteiskunnallisesti	PCLE_NOPEASTI	opt
yhteisvastuisesti	PCLE_NOPEASTI	opt
yhteisvastuullisesti	PCLE_NOPEASTI	opt
yhtenäisesti	PCLE_TYHMÄSTI	opt
yhtäaikaa	PCLE_KOTONA	opt
yhtäaikaisesti	PCLE_NOPEASTI	opt
yhtäjaksoisesti	PCLE_NOPEASTI	opt
yhtäkkisesti	PCLE_TYHMÄSTI	opt
yhtäläisesti	PCLE_TYHMÄSTI	opt
yhtämittaisesti	PCLE_NOPEASTI	opt
yhtäpitävästi	PCLE_TYHMÄSTI	opt
yksiköittäin	PCLE_TYHMÄSTI	opt
yksilöittäin	PCLE_TYHMÄSTI	opt
yksilökeskeisesti	PCLE_TYHMÄSTI	opt
yksilökohtaisesti	PCLE_NOPEASTI	opt
yksilöllisesti	PCLE_TYHMÄSTI	opt
yksimielisesti	PCLE_TYHMÄSTI	opt
yksinkertaisesti	PCLE_NOPEASTI	opt
yksinomaisesti	PCLE_NOPEASTI	opt
yksinvaltaisesti	PCLE_NOPEASTI	opt
yksinvaltiaasti	PCLE_NOPEASTI	opt
yksioikoisesti	PCLE_NOPEASTI	opt
yksipuolisesti	PCLE_NOPEASTI	opt
yksiselitteisesti	PCLE_TYHMÄSTI	opt
yksisilmäisesti	PCLE_TYHMÄSTI	opt
yksitoikkoisesti	PCLE_NOPEASTI	opt
yksitotisesti	PCLE_NOPEASTI	opt
yksittäin	PCLE_TYHMÄSTI	opt
yksittäisesti	PCLE_TYHMÄSTI	opt
yksituumaisesti	PCLE_NOPEASTI	opt
yksityisesti	PCLE_TYHMÄSTI	opt
yksityiskohdittain	PCLE_NOPEASTI	opt
yksityiskohtaisesti	PCLE_NOPEASTI	opt
yksivakaisesti	PCLE_NOPEASTI	opt
yksiviivaisesti	PCLE_NOPEASTI	opt
yleisesti	PCLE_TYHMÄSTI	opt
yleismaailmallisesti	PCLE_NOPEASTI	opt
yleispätevästi	PCLE_TYHMÄSTI	opt
yleistajuisesti	PCLE_NOPEASTI	opt
ylellisesti	PCLE_TYHMÄSTI	opt
ylenkatseellisesti	PCLE_NOPEASTI	opt
ylenpalttisesti	PCLE_NOPEASTI	opt
ylettömästi	PCLE_TYHMÄSTI	opt
ylhäisesti	PCLE_TYHMÄSTI	opt
ylhäältäpäin	PCLE_NÄKYVIIN	opt
yli-inhimillisesti	PCLE_TYHMÄSTI	opt
yliluonnollisesti	PCLE_NOPEASTI	opt
ylimaallisesti	PCLE_NOPEASTI	opt
ylimalkaisesti	PCLE_NOPEASTI	opt
ylimielisesti	PCLE_TYHMÄSTI	opt
ylimuistoisesti	PCLE_NOPEASTI	opt
ylimyksellisesti	PCLE_TYHMÄSTI	opt
yliolkaisesti	PCLE_NOPEASTI	opt
ylivoimaisesti	PCLE_NOPEASTI	opt
yllättävästi	PCLE_TYHMÄSTI	opt
yllätyksellisesti	PCLE_TYHMÄSTI	opt
ylpeästi	PCLE_TYHMÄSTI	opt
yltiöpäisesti	PCLE_TYHMÄSTI	opt
yltäkylläisesti	PCLE_TYHMÄSTI	opt
ylväästi	PCLE_TYHMÄSTI	opt
yläkanttiin	PCLE_VALTAAN	opt
ymmärrettävästi	PCLE_TYHMÄSTI	opt
ymmärtämättömästi	PCLE_TYHMÄSTI	opt
ymmärtäväisesti	PCLE_TYHMÄSTI	opt
ymmärtävästi	PCLE_TYHMÄSTI	opt
ympäripyöreästi	PCLE_TYHMÄSTI	opt
ynnä	PCLE_IKINÄ	opt
ynseästi	PCLE_TYHMÄSTI	opt
yritteliäästi	PCLE_TYHMÄSTI	opt
yrmeästi	PCLE_TYHMÄSTI	opt
ystävällisesti	PCLE_TYHMÄSTI	opt
ystävällismielisesti	PCLE_TYHMÄSTI	opt
ytimekkäästi	PCLE_TYHMÄSTI	opt
äidillisesti	PCLE_TYHMÄSTI	opt
äitelästi	PCLE_TYHMÄSTI	opt
äkeästi	PCLE_TYHMÄSTI	opt
äkillisesti	PCLE_TYHMÄSTI	opt
äkisti	PCLE_TYHMÄSTI	opt
äkkijyrkästi	PCLE_TYHMÄSTI	opt
äkkipikaisesti	PCLE_NOPEASTI	opt
äksysti	PCLE_TYHMÄSTI	opt
äkäisesti	PCLE_TYHMÄSTI	opt
älyllisesti	PCLE_TYHMÄSTI	opt
älyperäisesti	PCLE_TYHMÄSTI	opt
älyttömästi	PCLE_TYHMÄSTI	opt
ämpäreittäin	PCLE_TYHMÄSTI	opt
äreästi	PCLE_TYHMÄSTI	opt
ärhäkästi	PCLE_TYHMÄSTI	opt
ärtyisästi	PCLE_TYHMÄSTI	opt
äskettäin	PCLE_TYHMÄSTI	opt
ääliömäisesti	PCLE_TYHMÄSTI	opt
äänekkäästi	PCLE_TYHMÄSTI	opt
äänenpitävästi	PCLE_TYHMÄSTI	opt
äänettömästi	PCLE_TYHMÄSTI	opt
-äänisesti	PCLE_TYHMÄSTI	opt
äärettömästi	PCLE_TYHMÄSTI	opt
ääriin	PCLE_NÄKYVIIN	opt
öykkärimäisesti	PCLE_TYHMÄSTI	opt
