aakkosellisesti	['PCLE_NOPEASTI']	clit=opt
aakkosittain	['PCLE_VALTAAN']	clit=opt
aalloittain	['PCLE_VALTAAN']	clit=opt
aasimaisesti	['PCLE_NOPEASTI']	clit=opt
aatteellisesti	['PCLE_NOPEASTI']	clit=opt
aavemaisesti	['PCLE_NOPEASTI']	clit=opt
absoluuttisesti	['PCLE_NOPEASTI']	clit=opt
abstraktisesti	['PCLE_NOPEASTI']	clit=opt
abstraktisti	['PCLE_NOPEASTI']	clit=opt
absurdisti	['PCLE_NOPEASTI']	clit=opt
adekvaatisti	['PCLE_NOPEASTI']	clit=opt
adjektiivisesti	['PCLE_NOPEASTI']	clit=opt
adverbiaalisesti	['PCLE_NOPEASTI']	clit=opt
adverbisesti	['PCLE_NOPEASTI']	clit=opt
adversatiivisesti	['PCLE_NOPEASTI']	clit=opt
aerodynaamisesti	['PCLE_NOPEASTI']	clit=opt
affektiivisesti	['PCLE_NOPEASTI']	clit=opt
affektisesti	['PCLE_NOPEASTI']	clit=opt
aggressiivisesti	['PCLE_NOPEASTI']	clit=opt
agnostisesti	['PCLE_NOPEASTI']	clit=opt
ahdashenkisesti	['PCLE_TYHMÄSTI']	clit=opt
ahdasmielisesti	['PCLE_TYHMÄSTI']	clit=opt
ahdasnäköisesti	['PCLE_TYHMÄSTI']	clit=opt
ahdasrajaisesti	['PCLE_NOPEASTI']	clit=opt
ahdistuneesti	['PCLE_NOPEASTI']	clit=opt
ahkerasti	['PCLE_NOPEASTI']	clit=opt
ahnaasti	['PCLE_NOPEASTI']	clit=opt
ahneesti	['PCLE_NOPEASTI']	clit=opt
ahtaasti	['PCLE_NOPEASTI']	clit=opt
aidosti	['PCLE_NOPEASTI']	clit=opt
aiheellisesti	['PCLE_NOPEASTI']	clit=opt
aiheettomasti	['PCLE_NOPEASTI']	clit=opt
aikaan	['PCLE_VALTAAN']	clit=opt
aina	['PCLE_KOTONA']	clit=opt
aistikkaasti	['PCLE_NOPEASTI']	clit=opt
aistillisesti	['PCLE_NOPEASTI']	clit=opt
ajallisesti	['PCLE_NOPEASTI']	clit=opt
ajanmukaisesti	['PCLE_NOPEASTI']	clit=opt
ajattelemattomasti	['PCLE_NOPEASTI']	clit=opt
ajattomasti	['PCLE_NOPEASTI']	clit=opt
ajatuksellisesti	['PCLE_NOPEASTI']	clit=opt
ajatuksettomasti	['PCLE_NOPEASTI']	clit=opt
ajoittain	['PCLE_VALTAAN']	clit=opt
akateemisesti	['PCLE_NOPEASTI']	clit=opt
akkamaisesti	['PCLE_NOPEASTI']	clit=opt
aksiaalisesti	['PCLE_NOPEASTI']	clit=opt
aksiomaattisesti	['PCLE_NOPEASTI']	clit=opt
aktiivisesti	['PCLE_NOPEASTI']	clit=opt
aktuaalisesti	['PCLE_NOPEASTI']	clit=opt
akustisesti	['PCLE_NOPEASTI']	clit=opt
akuutisti	['PCLE_NOPEASTI']	clit=opt
ala-arvoisesti	['PCLE_NOPEASTI']	clit=opt
alakanttiin	['PCLE_VALTAAN']	clit=opt
alakuloisesti	['PCLE_NOPEASTI']	clit=opt
alamaisesti	['PCLE_NOPEASTI']	clit=opt
alasti	['PCLE_NOPEASTI']	clit=opt
alentavasti	['PCLE_NOPEASTI']	clit=opt
alentuvaisesti	['PCLE_NOPEASTI']	clit=opt
alentuvasti	['PCLE_NOPEASTI']	clit=opt
alhaisesti	['PCLE_NOPEASTI']	clit=opt
alitse	['PCLE_ALLE']	poss=opt
alituisesti	['PCLE_NOPEASTI']	clit=opt
alkeellisesti	['PCLE_NOPEASTI']	clit=opt
alkukantaisesti	['PCLE_NOPEASTI']	clit=opt
alkuperäisesti	['PCLE_TYHMÄSTI']	clit=opt
alla	['PCLE_KOTONA']	poss=opt
allegorisesti	['PCLE_NOPEASTI']	clit=opt
alle	['PCLE_ALLE']	poss=opt
aloittain	['PCLE_VALTAAN']	clit=opt
alta	['PCLE_KOTONA']	poss=opt
altruistisesti	['PCLE_NOPEASTI']	clit=opt
alttiisti	['PCLE_NOPEASTI']	clit=opt
alueellisesti	['PCLE_NOPEASTI']	clit=opt
alueittain	['PCLE_VALTAAN']	clit=opt
alustavasti	['PCLE_NOPEASTI']	clit=opt
ammateittain	['PCLE_VALTAAN']	clit=opt
ammatillisesti	['PCLE_NOPEASTI']	clit=opt
ammattimaisesti	['PCLE_NOPEASTI']	clit=opt
ammolla	['PCLE_KOTONA']	poss=opt
ammolle	['PCLE_ALLE']	poss=opt
anakronistisesti	['PCLE_NOPEASTI']	clit=opt
analgeettisesti	['PCLE_NOPEASTI']	clit=opt
analogisesti	['PCLE_NOPEASTI']	clit=opt
analyyttisesti	['PCLE_TYHMÄSTI']	clit=opt
anarkistisesti	['PCLE_NOPEASTI']	clit=opt
anatomisesti	['PCLE_NOPEASTI']	clit=opt
andrologisesti	['PCLE_NOPEASTI']	clit=opt
aneemisesti	['PCLE_NOPEASTI']	clit=opt
anestesiologisesti	['PCLE_NOPEASTI']	clit=opt
ankarasti	['PCLE_NOPEASTI']	clit=opt
ankeasti	['PCLE_NOPEASTI']	clit=opt
annoksittain	['PCLE_VALTAAN']	clit=opt
anomaalisesti	['PCLE_NOPEASTI']	clit=opt
ansaitusti	['PCLE_NOPEASTI']	clit=opt
ansiokkaasti	['PCLE_NOPEASTI']	clit=opt
ansiottomasti	['PCLE_NOPEASTI']	clit=opt
antaumuksellisesti	['PCLE_NOPEASTI']	clit=opt
anteeksiantamattomasti	['PCLE_NOPEASTI']	clit=opt
anteliaasti	['PCLE_NOPEASTI']	clit=opt
antisemiittisesti	['PCLE_TYHMÄSTI']	clit=opt
antoisasti	['PCLE_NOPEASTI']	clit=opt
antropologisesti	['PCLE_NOPEASTI']	clit=opt
apaattisesti	['PCLE_NOPEASTI']	clit=opt
apeasti	['PCLE_NOPEASTI']	clit=opt
apokryfisesti	['PCLE_TYHMÄSTI']	clit=opt
apriorisesti	['PCLE_NOPEASTI']	clit=opt
arasti	['PCLE_NOPEASTI']	clit=opt
aristokraattisesti	['PCLE_NOPEASTI']	clit=opt
arkaistisesti	['PCLE_NOPEASTI']	clit=opt
arkeittain	['PCLE_VALTAAN']	clit=opt
arkeologisesti	['PCLE_NOPEASTI']	clit=opt
arkisesti	['PCLE_NOPEASTI']	clit=opt
arkittain	['PCLE_VALTAAN']	clit=opt
arkkitehtonisesti	['PCLE_NOPEASTI']	clit=opt
armeliaasti	['PCLE_NOPEASTI']	clit=opt
armollisesti	['PCLE_NOPEASTI']	clit=opt
armottomasti	['PCLE_NOPEASTI']	clit=opt
arrogantisti	['PCLE_NOPEASTI']	clit=opt
arvaamattomasti	['PCLE_NOPEASTI']	clit=opt
arvattavasti	['PCLE_NOPEASTI']	clit=opt
arvelevasti	['PCLE_NOPEASTI']	clit=opt
arveluttavasti	['PCLE_NOPEASTI']	clit=opt
arvoituksellisesti	['PCLE_NOPEASTI']	clit=opt
arvokkaasti	['PCLE_NOPEASTI']	clit=opt
arvostelevasti	['PCLE_NOPEASTI']	clit=opt
arvostelukyvyttömästi	['PCLE_TYHMÄSTI']	clit=opt
arvottomasti	['PCLE_NOPEASTI']	clit=opt
arvovaltaisesti	['PCLE_NOPEASTI']	clit=opt
arvoväritteisesti	['PCLE_TYHMÄSTI']	clit=opt
asenteellisesti	['PCLE_NOPEASTI']	clit=opt
aseptisesti	['PCLE_NOPEASTI']	clit=opt
asiallisesti	['PCLE_NOPEASTI']	clit=opt
asianmukaisesti	['PCLE_NOPEASTI']	clit=opt
asiantuntevasti	['PCLE_NOPEASTI']	clit=opt
asiattomasti	['PCLE_NOPEASTI']	clit=opt
askeettisesti	['PCLE_NOPEASTI']	clit=opt
askelittain	['PCLE_VALTAAN']	clit=opt
askelmittain	['PCLE_VALTAAN']	clit=opt
asosiaalisesti	['PCLE_NOPEASTI']	clit=opt
asteittain	['PCLE_VALTAAN']	clit=opt
astioittain	['PCLE_VALTAAN']	clit=opt
asti	['PCLE_NOPEASTI']	clit=opt
astrologisesti	['PCLE_NOPEASTI']	clit=opt
astronomisesti	['PCLE_NOPEASTI']	clit=opt
asymmetrisesti	['PCLE_TYHMÄSTI']	clit=opt
atavistisesti	['PCLE_NOPEASTI']	clit=opt
ateistisesti	['PCLE_NOPEASTI']	clit=opt
attraktiivisesti	['PCLE_NOPEASTI']	clit=opt
auktoritatiivisesti	['PCLE_NOPEASTI']	clit=opt
auliisti	['PCLE_NOPEASTI']	clit=opt
aurinkoisesti	['PCLE_NOPEASTI']	clit=opt
automaattisesti	['PCLE_NOPEASTI']	clit=opt
autoritaarisesti	['PCLE_NOPEASTI']	clit=opt
autoritäärisesti	['PCLE_TYHMÄSTI']	clit=opt
auttamattomasti	['PCLE_NOPEASTI']	clit=opt
auttavasti	['PCLE_NOPEASTI']	clit=opt
autuaallisesti	['PCLE_NOPEASTI']	clit=opt
autuaasti	['PCLE_NOPEASTI']	clit=opt
avarakatseisesti	['PCLE_NOPEASTI']	clit=opt
avaramielisesti	['PCLE_TYHMÄSTI']	clit=opt
avoimesti	['PCLE_NOPEASTI']	clit=opt
avokatseisesti	['PCLE_NOPEASTI']	clit=opt
avokätisesti	['PCLE_TYHMÄSTI']	clit=opt
avomielisesti	['PCLE_NOPEASTI']	clit=opt
avonaisesti	['PCLE_NOPEASTI']	clit=opt
avosydämisesti	['PCLE_TYHMÄSTI']	clit=opt
avuliaasti	['PCLE_NOPEASTI']	clit=opt
avuttomasti	['PCLE_NOPEASTI']	clit=opt
bakteriologisesti	['PCLE_NOPEASTI']	clit=opt
banaalisti	['PCLE_NOPEASTI']	clit=opt
barbaarimaisesti	['PCLE_NOPEASTI']	clit=opt
barbaarisesti	['PCLE_NOPEASTI']	clit=opt
bilateraalisesti	['PCLE_NOPEASTI']	clit=opt
biodynaamisesti	['PCLE_NOPEASTI']	clit=opt
biokemiallisesti	['PCLE_NOPEASTI']	clit=opt
biologisesti	['PCLE_NOPEASTI']	clit=opt
bioteknisesti	['PCLE_TYHMÄSTI']	clit=opt
bisarristi	['PCLE_NOPEASTI']	clit=opt
biseksuaalisesti	['PCLE_NOPEASTI']	clit=opt
botaanisesti	['PCLE_NOPEASTI']	clit=opt
brežneviläisesti	['PCLE_TYHMÄSTI']	clit=opt
byrokraattisesti	['PCLE_NOPEASTI']	clit=opt
deduktiivisesti	['PCLE_NOPEASTI']	clit=opt
defensiivisesti	['PCLE_TYHMÄSTI']	clit=opt
definiittisesti	['PCLE_TYHMÄSTI']	clit=opt
definitiivisesti	['PCLE_TYHMÄSTI']	clit=opt
dekadentisti	['PCLE_NOPEASTI']	clit=opt
dekoratiivisesti	['PCLE_NOPEASTI']	clit=opt
demagogisesti	['PCLE_NOPEASTI']	clit=opt
demografisesti	['PCLE_NOPEASTI']	clit=opt
demokraattisesti	['PCLE_NOPEASTI']	clit=opt
demonisesti	['PCLE_NOPEASTI']	clit=opt
demonstratiivisesti	['PCLE_NOPEASTI']	clit=opt
depressiivisesti	['PCLE_TYHMÄSTI']	clit=opt
dermatologisesti	['PCLE_NOPEASTI']	clit=opt
deskriptiivisesti	['PCLE_TYHMÄSTI']	clit=opt
despoottisesti	['PCLE_NOPEASTI']	clit=opt
deterministisesti	['PCLE_TYHMÄSTI']	clit=opt
diagnostisesti	['PCLE_NOPEASTI']	clit=opt
dialektisesti	['PCLE_NOPEASTI']	clit=opt
didaktisesti	['PCLE_NOPEASTI']	clit=opt
digitaalisesti	['PCLE_NOPEASTI']	clit=opt
diktatorisesti	['PCLE_NOPEASTI']	clit=opt
dogmaattisesti	['PCLE_NOPEASTI']	clit=opt
dominantisti	['PCLE_NOPEASTI']	clit=opt
dorkasti	['PCLE_NOPEASTI']	clit=opt
draamallisesti	['PCLE_NOPEASTI']	clit=opt
dramaattisesti	['PCLE_NOPEASTI']	clit=opt
drastisesti	['PCLE_NOPEASTI']	clit=opt
dualistisesti	['PCLE_NOPEASTI']	clit=opt
dynaamisesti	['PCLE_NOPEASTI']	clit=opt
edelle	['PCLE_YLLE']	poss=opt
edellä	['PCLE_IKINÄ']	poss=opt
edeltä	['PCLE_IKINÄ']	poss=opt
edessä	['PCLE_IKINÄ']	poss=opt
edestä	['PCLE_IKINÄ']	poss=opt
edesvastuuttomasti	['PCLE_NOPEASTI']	clit=opt
edistyksellisesti	['PCLE_TYHMÄSTI']	clit=opt
editse	['PCLE_YLLE']	poss=opt
edullisesti	['PCLE_NOPEASTI']	clit=opt
edustavasti	['PCLE_NOPEASTI']	clit=opt
eettisesti	['PCLE_TYHMÄSTI']	clit=opt
efektiivisesti	['PCLE_TYHMÄSTI']	clit=opt
egoistisesti	['PCLE_NOPEASTI']	clit=opt
egosentrisesti	['PCLE_TYHMÄSTI']	clit=opt
ehdollisesti	['PCLE_NOPEASTI']	clit=opt
ehdottomasti	['PCLE_NOPEASTI']	clit=opt
eheästi	['PCLE_TYHMÄSTI']	clit=opt
ehjästi	['PCLE_TYHMÄSTI']	clit=opt
-ehtoisesti	['PCLE_NOPEASTI']	clit=opt
ei-leksikaalisesti	['PCLE_NOPEASTI']	clit=opt
ekologisesti	['PCLE_NOPEASTI']	clit=opt
ekonometrisesti	['PCLE_NOPEASTI']	clit=opt
ekonomisesti	['PCLE_NOPEASTI']	clit=opt
eksaktisti	['PCLE_NOPEASTI']	clit=opt
eksentrisesti	['PCLE_TYHMÄSTI']	clit=opt
eksoottisesti	['PCLE_NOPEASTI']	clit=opt
ekspansiivisesti	['PCLE_NOPEASTI']	clit=opt
eksplisiittisesti	['PCLE_TYHMÄSTI']	clit=opt
eksponentiaalisesti	['PCLE_NOPEASTI']	clit=opt
ekspressiivisesti	['PCLE_TYHMÄSTI']	clit=opt
ekstaattisesti	['PCLE_NOPEASTI']	clit=opt
eksyksiin	['PCLE_NÄKYVIIN']	poss=opt
ekumeenisesti	['PCLE_NOPEASTI']	clit=opt
elastisesti	['PCLE_NOPEASTI']	clit=opt
eleettömästi	['PCLE_TYHMÄSTI']	clit=opt
elegantisti	['PCLE_NOPEASTI']	clit=opt
elegisesti	['PCLE_TYHMÄSTI']	clit=opt
-eleisesti	['PCLE_TYHMÄSTI']	clit=opt
elektrolyyttisesti	['PCLE_TYHMÄSTI']	clit=opt
elektronisesti	['PCLE_NOPEASTI']	clit=opt
elementaarisesti	['PCLE_NOPEASTI']	clit=opt
elimellisesti	['PCLE_TYHMÄSTI']	clit=opt
eloisasti	['PCLE_NOPEASTI']	clit=opt
elottomasti	['PCLE_NOPEASTI']	clit=opt
eläimellisesti	['PCLE_TYHMÄSTI']	clit=opt
elämyksellisesti	['PCLE_TYHMÄSTI']	clit=opt
elämänkatsomuksellisesti	['PCLE_NOPEASTI']	clit=opt
elämänkielteisesti	['PCLE_TYHMÄSTI']	clit=opt
elämänläheisesti	['PCLE_TYHMÄSTI']	clit=opt
elämänmyönteisesti	['PCLE_TYHMÄSTI']	clit=opt
elävästi	['PCLE_TYHMÄSTI']	clit=opt
embryologisesti	['PCLE_NOPEASTI']	clit=opt
emotionaalisesti	['PCLE_NOPEASTI']	clit=opt
empaattisesti	['PCLE_NOPEASTI']	clit=opt
empiirisesti	['PCLE_TYHMÄSTI']	clit=opt
emäksisesti	['PCLE_TYHMÄSTI']	clit=opt
endeemisesti	['PCLE_TYHMÄSTI']	clit=opt
endokrinologisesti	['PCLE_NOPEASTI']	clit=opt
enenevästi	['PCLE_TYHMÄSTI']	clit=opt
energisesti	['PCLE_TYHMÄSTI']	clit=opt
ennakkoluuloisesti	['PCLE_NOPEASTI']	clit=opt
ennakkoluulottomasti	['PCLE_NOPEASTI']	clit=opt
ennen	['PCLE_LIKI']	clit=opt
ennenaikaisesti	['PCLE_NOPEASTI']	clit=opt
ennenkuulumattomasti	['PCLE_NOPEASTI']	clit=opt
ennennäkemättömästi	['PCLE_TYHMÄSTI']	clit=opt
ennen	['PCLE_NÄKYVIIN']	clit=opt
ennätyksellisesti	['PCLE_TYHMÄSTI']	clit=opt
ennätysmäisesti	['PCLE_TYHMÄSTI']	clit=opt
ensiluokkaisesti	['PCLE_NOPEASTI']	clit=opt
ensin	['PCLE_NÄKYVIIN']	clit=opt
ensisijaisesti	['PCLE_NOPEASTI']	clit=opt
enteellisesti	['PCLE_TYHMÄSTI']	clit=opt
epidemiologisesti	['PCLE_NOPEASTI']	clit=opt
epäaidosti	['PCLE_NOPEASTI']	clit=opt
epäasiallisesti	['PCLE_NOPEASTI']	clit=opt
epädemokraattisesti	['PCLE_NOPEASTI']	clit=opt
epäedullisesti	['PCLE_NOPEASTI']	clit=opt
epäesteettisesti	['PCLE_TYHMÄSTI']	clit=opt
epähavainnollisesti	['PCLE_NOPEASTI']	clit=opt
epähienosti	['PCLE_NOPEASTI']	clit=opt
epähistoriallisesti	['PCLE_NOPEASTI']	clit=opt
epähygieenisesti	['PCLE_TYHMÄSTI']	clit=opt
epäilevästi	['PCLE_TYHMÄSTI']	clit=opt
epäilyttävästi	['PCLE_TYHMÄSTI']	clit=opt
epäinhimillisesti	['PCLE_TYHMÄSTI']	clit=opt
epäitsekkäästi	['PCLE_TYHMÄSTI']	clit=opt
epäitsenäisesti	['PCLE_TYHMÄSTI']	clit=opt
epäjohdonmukaisesti	['PCLE_NOPEASTI']	clit=opt
epäjumalallisesti	['PCLE_NOPEASTI']	clit=opt
epäkeskisesti	['PCLE_TYHMÄSTI']	clit=opt
epäkiitollisesti	['PCLE_NOPEASTI']	clit=opt
epäkohteliaasti	['PCLE_NOPEASTI']	clit=opt
epäkriittisesti	['PCLE_TYHMÄSTI']	clit=opt
epäkristillisesti	['PCLE_TYHMÄSTI']	clit=opt
epäkunnioittavasti	['PCLE_NOPEASTI']	clit=opt
epäkypsästi	['PCLE_TYHMÄSTI']	clit=opt
epäkäytännöllisesti	['PCLE_TYHMÄSTI']	clit=opt
epälojaalisesti	['PCLE_NOPEASTI']	clit=opt
epälojaalisti	['PCLE_NOPEASTI']	clit=opt
epäloogisesti	['PCLE_NOPEASTI']	clit=opt
epäluonnollisesti	['PCLE_NOPEASTI']	clit=opt
epäluotettavasti	['PCLE_NOPEASTI']	clit=opt
epäluuloisesti	['PCLE_NOPEASTI']	clit=opt
epämiehekkäästi	['PCLE_TYHMÄSTI']	clit=opt
epämiellyttävästi	['PCLE_TYHMÄSTI']	clit=opt
epämieluisasti	['PCLE_NOPEASTI']	clit=opt
epämukavasti	['PCLE_NOPEASTI']	clit=opt
epämuodollisesti	['PCLE_NOPEASTI']	clit=opt
epämusikaalisesti	['PCLE_NOPEASTI']	clit=opt
epämääräisesti	['PCLE_TYHMÄSTI']	clit=opt
epänaisellisesti	['PCLE_NOPEASTI']	clit=opt
epänormaalisti	['PCLE_NOPEASTI']	clit=opt
epäoikeudenmukaisesti	['PCLE_NOPEASTI']	clit=opt
epäolennaisesti	['PCLE_NOPEASTI']	clit=opt
epäortodoksisesti	['PCLE_NOPEASTI']	clit=opt
epäparlamentaarisesti	['PCLE_NOPEASTI']	clit=opt
epäpoliittisesti	['PCLE_NOPEASTI']	clit=opt
epäpuhtaasti	['PCLE_NOPEASTI']	clit=opt
epäpätevästi	['PCLE_TYHMÄSTI']	clit=opt
epärealistisesti	['PCLE_NOPEASTI']	clit=opt
epärehellisesti	['PCLE_TYHMÄSTI']	clit=opt
epäreilusti	['PCLE_NOPEASTI']	clit=opt
epäselvästi	['PCLE_TYHMÄSTI']	clit=opt
epäsiististi	['PCLE_TYHMÄSTI']	clit=opt
epäsiveellisesti	['PCLE_TYHMÄSTI']	clit=opt
epäsointuisesti	['PCLE_NOPEASTI']	clit=opt
epäsopuisesti	['PCLE_NOPEASTI']	clit=opt
epäsosiaalisesti	['PCLE_NOPEASTI']	clit=opt
epäsovinnaisesti	['PCLE_NOPEASTI']	clit=opt
epäsuhtaisesti	['PCLE_NOPEASTI']	clit=opt
epäsuomalaisesti	['PCLE_NOPEASTI']	clit=opt
epäsuopeasti	['PCLE_NOPEASTI']	clit=opt
epäsuorasti	['PCLE_NOPEASTI']	clit=opt
epäsuosiollisesti	['PCLE_NOPEASTI']	clit=opt
epäsuotuisasti	['PCLE_NOPEASTI']	clit=opt
epäsymmetrisesti	['PCLE_TYHMÄSTI']	clit=opt
epäsäännöllisesti	['PCLE_TYHMÄSTI']	clit=opt
epätaiteellisesti	['PCLE_NOPEASTI']	clit=opt
epätaloudellisesti	['PCLE_NOPEASTI']	clit=opt
epätarkasti	['PCLE_NOPEASTI']	clit=opt
epätarkoituksenmukaisesti	['PCLE_NOPEASTI']	clit=opt
epätasaisesti	['PCLE_NOPEASTI']	clit=opt
epätavallisesti	['PCLE_NOPEASTI']	clit=opt
epäterveellisesti	['PCLE_TYHMÄSTI']	clit=opt
epäterveesti	['PCLE_TYHMÄSTI']	clit=opt
epätieteellisesti	['PCLE_TYHMÄSTI']	clit=opt
epätodennäköisesti	['PCLE_TYHMÄSTI']	clit=opt
epätoivoisesti	['PCLE_NOPEASTI']	clit=opt
epätyydyttävästi	['PCLE_TYHMÄSTI']	clit=opt
epätäsmällisesti	['PCLE_TYHMÄSTI']	clit=opt
epätäydellisesti	['PCLE_TYHMÄSTI']	clit=opt
epäurheilijamaisesti	['PCLE_NOPEASTI']	clit=opt
epäuskoisesti	['PCLE_NOPEASTI']	clit=opt
epäuskottavasti	['PCLE_NOPEASTI']	clit=opt
epävakaasti	['PCLE_NOPEASTI']	clit=opt
epävakaisesti	['PCLE_NOPEASTI']	clit=opt
epävarmasti	['PCLE_NOPEASTI']	clit=opt
epäviihtyisästi	['PCLE_TYHMÄSTI']	clit=opt
epäviisaasti	['PCLE_NOPEASTI']	clit=opt
epävirallisesti	['PCLE_NOPEASTI']	clit=opt
epävireisesti	['PCLE_TYHMÄSTI']	clit=opt
epäyhtenäisesti	['PCLE_TYHMÄSTI']	clit=opt
epäystävällisesti	['PCLE_TYHMÄSTI']	clit=opt
epäämättömästi	['PCLE_TYHMÄSTI']	clit=opt
ergonomisesti	['PCLE_NOPEASTI']	clit=opt
erheellisesti	['PCLE_TYHMÄSTI']	clit=opt
eriaikaisesti	['PCLE_NOPEASTI']	clit=opt
eriasteisesti	['PCLE_NOPEASTI']	clit=opt
erikoisesti	['PCLE_NOPEASTI']	clit=opt
erikoislaatuisesti	['PCLE_NOPEASTI']	clit=opt
erimielisesti	['PCLE_TYHMÄSTI']	clit=opt
erimuotoisesti	['PCLE_NOPEASTI']	clit=opt
erinomaisesti	['PCLE_NOPEASTI']	clit=opt
eripuraisesti	['PCLE_NOPEASTI']	clit=opt
eriskummallisesti	['PCLE_NOPEASTI']	clit=opt
erisuuntaisesti	['PCLE_NOPEASTI']	clit=opt
eritasoisesti	['PCLE_NOPEASTI']	clit=opt
erittäin	['PCLE_NÄKYVIIN']	clit=opt
erityisen	['PCLE_NÄKYVIIN']	clit=opt
erityisesti	['PCLE_TYHMÄSTI']	clit=opt
erityyppisesti	['PCLE_TYHMÄSTI']	clit=opt
eriyttävästi	['PCLE_TYHMÄSTI']	clit=opt
eroottisesti	['PCLE_NOPEASTI']	clit=opt
erottamattomasti	['PCLE_NOPEASTI']	clit=opt
esikuvallisesti	['PCLE_NOPEASTI']	clit=opt
esimerkillisesti	['PCLE_TYHMÄSTI']	clit=opt
esteettisesti	['PCLE_TYHMÄSTI']	clit=opt
estottomasti	['PCLE_NOPEASTI']	clit=opt
eteen	['PCLE_NÄKYVIIN']	poss=opt
eteerisesti	['PCLE_TYHMÄSTI']	clit=opt
etevästi	['PCLE_TYHMÄSTI']	clit=opt
etiologisesti	['PCLE_NOPEASTI']	clit=opt
etnisesti	['PCLE_TYHMÄSTI']	clit=opt
etnografisesti	['PCLE_NOPEASTI']	clit=opt
etnologisesti	['PCLE_NOPEASTI']	clit=opt
etupainotteisesti	['PCLE_NOPEASTI']	clit=opt
etymologisesti	['PCLE_NOPEASTI']	clit=opt
etäisesti	['PCLE_TYHMÄSTI']	clit=opt
eufemistisesti	['PCLE_NOPEASTI']	clit=opt
euforisesti	['PCLE_NOPEASTI']	clit=opt
faktisesti	['PCLE_NOPEASTI']	clit=opt
fakultatiivisesti	['PCLE_NOPEASTI']	clit=opt
falskisti	['PCLE_NOPEASTI']	clit=opt
fanaattisesti	['PCLE_NOPEASTI']	clit=opt
fantastisesti	['PCLE_NOPEASTI']	clit=opt
farmakologisesti	['PCLE_NOPEASTI']	clit=opt
fataalisesti	['PCLE_NOPEASTI']	clit=opt
fataalisti	['PCLE_NOPEASTI']	clit=opt
fatalistisesti	['PCLE_NOPEASTI']	clit=opt
feminiinisesti	['PCLE_TYHMÄSTI']	clit=opt
feministisesti	['PCLE_TYHMÄSTI']	clit=opt
fennistisesti	['PCLE_TYHMÄSTI']	clit=opt
fenomenaalisesti	['PCLE_NOPEASTI']	clit=opt
fenomenologisesti	['PCLE_NOPEASTI']	clit=opt
feodaalisesti	['PCLE_NOPEASTI']	clit=opt
feodalistisesti	['PCLE_NOPEASTI']	clit=opt
figuratiivisesti	['PCLE_NOPEASTI']	clit=opt
fiksusti	['PCLE_NOPEASTI']	clit=opt
fiktiivisesti	['PCLE_TYHMÄSTI']	clit=opt
filantrooppisesti	['PCLE_NOPEASTI']	clit=opt
filmaattisesti	['PCLE_NOPEASTI']	clit=opt
filologisesti	['PCLE_NOPEASTI']	clit=opt
filosofisesti	['PCLE_NOPEASTI']	clit=opt
finaalisesti	['PCLE_NOPEASTI']	clit=opt
flegmaattisesti	['PCLE_NOPEASTI']	clit=opt
foneettisesti	['PCLE_NOPEASTI']	clit=opt
foniatrisesti	['PCLE_NOPEASTI']	clit=opt
fonologisesti	['PCLE_NOPEASTI']	clit=opt
formaalisesti	['PCLE_NOPEASTI']	clit=opt
formaalisti	['PCLE_NOPEASTI']	clit=opt
formalistisesti	['PCLE_NOPEASTI']	clit=opt
fragmentaarisesti	['PCLE_NOPEASTI']	clit=opt
frontaalisesti	['PCLE_NOPEASTI']	clit=opt
fundamentaalisesti	['PCLE_NOPEASTI']	clit=opt
fundamentalistisesti	['PCLE_NOPEASTI']	clit=opt
funktionaalisesti	['PCLE_NOPEASTI']	clit=opt
funktionalistisesti	['PCLE_NOPEASTI']	clit=opt
futurologisesti	['PCLE_NOPEASTI']	clit=opt
fylogeneettisesti	['PCLE_NOPEASTI']	clit=opt
fysiatrisesti	['PCLE_NOPEASTI']	clit=opt
fysikaalisesti	['PCLE_NOPEASTI']	clit=opt
fysiologisesti	['PCLE_NOPEASTI']	clit=opt
fyysisesti	['PCLE_TYHMÄSTI']	clit=opt
galvaanisesti	['PCLE_NOPEASTI']	clit=opt
gastronomisesti	['PCLE_NOPEASTI']	clit=opt
gemmologisesti	['PCLE_NOPEASTI']	clit=opt
geneettisesti	['PCLE_TYHMÄSTI']	clit=opt
geodeettisesti	['PCLE_NOPEASTI']	clit=opt
geofysikaalisesti	['PCLE_NOPEASTI']	clit=opt
geologisesti	['PCLE_NOPEASTI']	clit=opt
geometrisesti	['PCLE_NOPEASTI']	clit=opt
geomorfologisesti	['PCLE_NOPEASTI']	clit=opt
geopoliittisesti	['PCLE_NOPEASTI']	clit=opt
geriatrisesti	['PCLE_NOPEASTI']	clit=opt
giganttisesti	['PCLE_NOPEASTI']	clit=opt
globaalisesti	['PCLE_NOPEASTI']	clit=opt
globaalisti	['PCLE_NOPEASTI']	clit=opt
gnostisistisesti	['PCLE_NOPEASTI']	clit=opt
graafisesti	['PCLE_NOPEASTI']	clit=opt
grafologisesti	['PCLE_NOPEASTI']	clit=opt
grammaattisesti	['PCLE_NOPEASTI']	clit=opt
haaveellisesti	['PCLE_NOPEASTI']	clit=opt
haikeasti	['PCLE_NOPEASTI']	clit=opt
haitallisesti	['PCLE_NOPEASTI']	clit=opt
haitattomasti	['PCLE_NOPEASTI']	clit=opt
hajalla	['PCLE_KOTONA']	poss=opt
hajalle	['PCLE_ALLE']	poss=opt
hajamielisesti	['PCLE_TYHMÄSTI']	clit=opt
hajanaisesti	['PCLE_NOPEASTI']	clit=opt
hajuttomasti	['PCLE_NOPEASTI']	clit=opt
-hakuisesti	['PCLE_NOPEASTI']	clit=opt
hallinnollisesti	['PCLE_NOPEASTI']	clit=opt
hallitusti	['PCLE_NOPEASTI']	clit=opt
hallussa	['PCLE_KOTONA']	poss=opt
hallusta	['PCLE_KOTONA']	poss=opt
halpamaisesti	['PCLE_NOPEASTI']	clit=opt
haltuun	['PCLE_VALTAAN']	poss=opt
halukkaasti	['PCLE_NOPEASTI']	clit=opt
haluttomasti	['PCLE_NOPEASTI']	clit=opt
halventavasti	['PCLE_NOPEASTI']	clit=opt
hampaattomasti	['PCLE_NOPEASTI']	clit=opt
hampaissa	['PCLE_KOTONA']	poss=opt
hampaista	['PCLE_KOTONA']	poss=opt
hanakasti	['PCLE_NOPEASTI']	clit=opt
hanttiin	['PCLE_VALTAAN']	clit=opt
happamasti	['PCLE_NOPEASTI']	clit=opt
happamesti	['PCLE_NOPEASTI']	clit=opt
haralla	['PCLE_KOTONA']	poss=opt
haralle	['PCLE_ALLE']	poss=opt
harilla	['PCLE_KOTONA']	poss=opt
harille	['PCLE_ALLE']	poss=opt
harkitsemattomasti	['PCLE_NOPEASTI']	clit=opt
harkitusti	['PCLE_NOPEASTI']	clit=opt
hartaasti	['PCLE_NOPEASTI']	clit=opt
hassusti	['PCLE_NOPEASTI']	clit=opt
hatarasti	['PCLE_NOPEASTI']	clit=opt
haudanvakavasti	['PCLE_NOPEASTI']	clit=opt
hauskasti	['PCLE_NOPEASTI']	clit=opt
havainnollisesti	['PCLE_NOPEASTI']	clit=opt
havaittavasti	['PCLE_NOPEASTI']	clit=opt
hedelmällisesti	['PCLE_TYHMÄSTI']	clit=opt
heikosti	['PCLE_NOPEASTI']	clit=opt
hektisesti	['PCLE_TYHMÄSTI']	clit=opt
hekumallisesti	['PCLE_NOPEASTI']	clit=opt
helakasti	['PCLE_NOPEASTI']	clit=opt
heleästi	['PCLE_TYHMÄSTI']	clit=opt
helkkaristi	['PCLE_NOPEASTI']	clit=opt
hellittämättömästi	['PCLE_TYHMÄSTI']	clit=opt
helläkätisesti	['PCLE_TYHMÄSTI']	clit=opt
hellästi	['PCLE_TYHMÄSTI']	clit=opt
hellävaraisesti	['PCLE_NOPEASTI']	clit=opt
helposti	['PCLE_NOPEASTI']	clit=opt
helpottuneesti	['PCLE_NOPEASTI']	clit=opt
helppotajuisesti	['PCLE_NOPEASTI']	clit=opt
helteisesti	['PCLE_TYHMÄSTI']	clit=opt
helvetisti	['PCLE_TYHMÄSTI']	clit=opt
hemaisevasti	['PCLE_NOPEASTI']	clit=opt
hemmetisti	['PCLE_TYHMÄSTI']	clit=opt
hempeästi	['PCLE_TYHMÄSTI']	clit=opt
hengenvaarallisesti	['PCLE_NOPEASTI']	clit=opt
hengettömästi	['PCLE_TYHMÄSTI']	clit=opt
henkevästi	['PCLE_TYHMÄSTI']	clit=opt
henkilökohtaisesti	['PCLE_NOPEASTI']	clit=opt
henkisesti	['PCLE_TYHMÄSTI']	clit=opt
henkitoreihin	['PCLE_VALTAAN']	poss=opt
heppoisesti	['PCLE_NOPEASTI']	clit=opt
hereille	['PCLE_YLLE']	poss=opt
hereillä	['PCLE_IKINÄ']	poss=opt
hereästi	['PCLE_TYHMÄSTI']	clit=opt
herkeämättömästi	['PCLE_TYHMÄSTI']	clit=opt
herkullisesti	['PCLE_NOPEASTI']	clit=opt
herkästi	['PCLE_TYHMÄSTI']	clit=opt
hermeettisesti	['PCLE_TYHMÄSTI']	clit=opt
hermostuneesti	['PCLE_NOPEASTI']	clit=opt
herraskaisesti	['PCLE_NOPEASTI']	clit=opt
herttaisesti	['PCLE_NOPEASTI']	clit=opt
hervottomasti	['PCLE_NOPEASTI']	clit=opt
hetkellisesti	['PCLE_TYHMÄSTI']	clit=opt
hetkittäin	['PCLE_NÄKYVIIN']	clit=opt
hevoskuormittain	['PCLE_VALTAAN']	clit=opt
hienoisesti	['PCLE_NOPEASTI']	clit=opt
hienosti	['PCLE_NOPEASTI']	clit=opt
hienostuneesti	['PCLE_NOPEASTI']	clit=opt
hienotunteisesti	['PCLE_NOPEASTI']	clit=opt
hienovaraisesti	['PCLE_NOPEASTI']	clit=opt
hiipivästi	['PCLE_TYHMÄSTI']	clit=opt
hiivatisti	['PCLE_NOPEASTI']	clit=opt
hiljaisesti	['PCLE_NOPEASTI']	clit=opt
hiljattain	['PCLE_VALTAAN']	clit=opt
hillittömästi	['PCLE_TYHMÄSTI']	clit=opt
hillitysti	['PCLE_TYHMÄSTI']	clit=opt
hilpeästi	['PCLE_TYHMÄSTI']	clit=opt
himmeästi	['PCLE_TYHMÄSTI']	clit=opt
himokkaasti	['PCLE_NOPEASTI']	clit=opt
hirmuisesti	['PCLE_NOPEASTI']	clit=opt
hirveästi	['PCLE_TYHMÄSTI']	clit=opt
hirvittävästi	['PCLE_TYHMÄSTI']	clit=opt
hitaasti	['PCLE_NOPEASTI']	clit=opt
hitosti	['PCLE_NOPEASTI']	clit=opt
hiuksenhienosti	['PCLE_NOPEASTI']	clit=opt
hohdokkaasti	['PCLE_NOPEASTI']	clit=opt
holtittomasti	['PCLE_NOPEASTI']	clit=opt
huikeasti	['PCLE_NOPEASTI']	clit=opt
huikentelevaisesti	['PCLE_NOPEASTI']	clit=opt
huikentelevasti	['PCLE_NOPEASTI']	clit=opt
huimaavasti	['PCLE_NOPEASTI']	clit=opt
huimapäisesti	['PCLE_TYHMÄSTI']	clit=opt
huimasti	['PCLE_NOPEASTI']	clit=opt
hullunkurisesti	['PCLE_NOPEASTI']	clit=opt
hullusti	['PCLE_NOPEASTI']	clit=opt
humoristisesti	['PCLE_NOPEASTI']	clit=opt
hunajaisesti	['PCLE_NOPEASTI']	clit=opt
huolehtivaisesti	['PCLE_NOPEASTI']	clit=opt
huolellisesti	['PCLE_NOPEASTI']	clit=opt
huolettomasti	['PCLE_NOPEASTI']	clit=opt
huolimattomasti	['PCLE_NOPEASTI']	clit=opt
huomaamattomasti	['PCLE_NOPEASTI']	clit=opt
huomaavaisesti	['PCLE_NOPEASTI']	clit=opt
huomassa	['PCLE_KOTONA']	poss=opt
huomattavasti	['PCLE_NOPEASTI']	clit=opt
huonosti	['PCLE_NOPEASTI']	clit=opt
huostassa	['PCLE_KOTONA']	poss=opt
hupaisasti	['PCLE_NOPEASTI']	clit=opt
hupsusti	['PCLE_NOPEASTI']	clit=opt
hurjasti	['PCLE_NOPEASTI']	clit=opt
hurmaavasti	['PCLE_NOPEASTI']	clit=opt
hurskaasti	['PCLE_NOPEASTI']	clit=opt
huumorintajuisesti	['PCLE_NOPEASTI']	clit=opt
hydraulisesti	['PCLE_NOPEASTI']	clit=opt
hygieenisesti	['PCLE_TYHMÄSTI']	clit=opt
hyisesti	['PCLE_TYHMÄSTI']	clit=opt
hypnoottisesti	['PCLE_NOPEASTI']	clit=opt
hyppäyksittäin	['PCLE_NÄKYVIIN']	clit=opt
hysteerisesti	['PCLE_TYHMÄSTI']	clit=opt
hyveellisesti	['PCLE_TYHMÄSTI']	clit=opt
hyväksyttävästi	['PCLE_TYHMÄSTI']	clit=opt
hyvänsuovasti	['PCLE_NOPEASTI']	clit=opt
hyväntahtoisesti	['PCLE_NOPEASTI']	clit=opt
hyväntuulisesti	['PCLE_NOPEASTI']	clit=opt
hyvästi	['N_TYYLI']	clit=opt
hyvästi	['PCLE_TYHMÄSTI']	clit=opt
hyväsydämisesti	['PCLE_TYHMÄSTI']	clit=opt
hyväuskoisesti	['PCLE_NOPEASTI']	clit=opt
hyödyllisesti	['PCLE_TYHMÄSTI']	clit=opt
hyödyttömästi	['PCLE_TYHMÄSTI']	clit=opt
hyökkäävästi	['PCLE_TYHMÄSTI']	clit=opt
häijysti	['PCLE_TYHMÄSTI']	clit=opt
häikäilemättömästi	['PCLE_TYHMÄSTI']	clit=opt
häkellyksiin	['PCLE_NÄKYVIIN']	poss=opt
häkellyksissä	['PCLE_IKINÄ']	poss=opt
hälyttävästi	['PCLE_TYHMÄSTI']	clit=opt
hämmennyksiin	['PCLE_NÄKYVIIN']	poss=opt
hämmennyksissä	['PCLE_IKINÄ']	poss=opt
hämäläisittäin	['PCLE_NÄKYVIIN']	clit=opt
hämärästi	['PCLE_TYHMÄSTI']	clit=opt
hämäännyksiin	['PCLE_NÄKYVIIN']	poss=opt
hämäännyksissä	['PCLE_IKINÄ']	poss=opt
häpeällisesti	['PCLE_TYHMÄSTI']	clit=opt
häpeämättömästi	['PCLE_TYHMÄSTI']	clit=opt
härkäpäisesti	['PCLE_TYHMÄSTI']	clit=opt
härskisti	['PCLE_TYHMÄSTI']	clit=opt
hätäisesti	['PCLE_TYHMÄSTI']	clit=opt
hätäännyksissä	['PCLE_IKINÄ']	poss=obl
häveliäästi	['PCLE_TYHMÄSTI']	clit=opt
hävyttömästi	['PCLE_TYHMÄSTI']	clit=opt
häävisti	['PCLE_TYHMÄSTI']	clit=opt
hölläkätisesti	['PCLE_TYHMÄSTI']	clit=opt
höllästi	['PCLE_TYHMÄSTI']	clit=opt
hölmösti	['PCLE_TYHMÄSTI']	clit=opt
höperösti	['PCLE_TYHMÄSTI']	clit=opt
hörölle	['PCLE_YLLE']	poss=opt
höröllä	['PCLE_IKINÄ']	poss=opt
hövelisti	['PCLE_TYHMÄSTI']	clit=opt
höylisti	['PCLE_TYHMÄSTI']	clit=opt
iankaikkisesti	['PCLE_NOPEASTI']	clit=opt
identtisesti	['PCLE_TYHMÄSTI']	clit=opt
idioottimaisesti	['PCLE_NOPEASTI']	clit=opt
idyllisesti	['PCLE_TYHMÄSTI']	clit=opt
ihailevasti	['PCLE_NOPEASTI']	clit=opt
ihailtavasti	['PCLE_NOPEASTI']	clit=opt
ihanasti	['PCLE_NOPEASTI']	clit=opt
ihanteellisesti	['PCLE_NOPEASTI']	clit=opt
ihastuttavasti	['PCLE_NOPEASTI']	clit=opt
ihmeellisesti	['PCLE_TYHMÄSTI']	clit=opt
ihmeesti	['PCLE_TYHMÄSTI']	clit=opt
ihmeteltävästi	['PCLE_TYHMÄSTI']	clit=opt
ihmisläheisesti	['PCLE_TYHMÄSTI']	clit=opt
ihmismäisesti	['PCLE_TYHMÄSTI']	clit=opt
iisisti	['PCLE_TYHMÄSTI']	clit=opt
ikinä	['PCLE_IKINÄ']	poss=opt
ikuisesti	['PCLE_NOPEASTI']	clit=opt
ikänä	['PCLE_IKINÄ']	poss=opt
ikävystyneesti	['PCLE_TYHMÄSTI']	clit=opt
ikävystyttävästi	['PCLE_TYHMÄSTI']	clit=opt
ikävästi	['PCLE_TYHMÄSTI']	clit=opt
iljettävästi	['PCLE_TYHMÄSTI']	clit=opt
ilkeästi	['PCLE_TYHMÄSTI']	clit=opt
ilkialasti	['PCLE_NOPEASTI']	clit=opt
ilkikurisesti	['PCLE_NOPEASTI']	clit=opt
ilkivaltaisesti	['PCLE_NOPEASTI']	clit=opt
ilmanpitävästi	['PCLE_TYHMÄSTI']	clit=opt
ilmastollisesti	['PCLE_NOPEASTI']	clit=opt
ilmatiiviisti	['PCLE_TYHMÄSTI']	clit=opt
ilmavasti	['PCLE_NOPEASTI']	clit=opt
ilmeettömästi	['PCLE_TYHMÄSTI']	clit=opt
ilmeikkäästi	['PCLE_TYHMÄSTI']	clit=opt
ilmeisesti	['PCLE_TYHMÄSTI']	clit=opt
ilmielävästi	['PCLE_TYHMÄSTI']	clit=opt
ilmiselvästi	['PCLE_TYHMÄSTI']	clit=opt
ilmiömäisesti	['PCLE_TYHMÄSTI']	clit=opt
iloisesti	['PCLE_NOPEASTI']	clit=opt
ilottomasti	['PCLE_NOPEASTI']	clit=opt
imelästi	['PCLE_TYHMÄSTI']	clit=opt
implisiittisesti	['PCLE_TYHMÄSTI']	clit=opt
impulsiivisesti	['PCLE_NOPEASTI']	clit=opt
individualistisesti	['PCLE_NOPEASTI']	clit=opt
inhimillisesti	['PCLE_TYHMÄSTI']	clit=opt
inhottavasti	['PCLE_NOPEASTI']	clit=opt
innokkaasti	['PCLE_NOPEASTI']	clit=opt
innostuneesti	['PCLE_NOPEASTI']	clit=opt
innottomasti	['PCLE_NOPEASTI']	clit=opt
intensiivisesti	['PCLE_TYHMÄSTI']	clit=opt
interaktiivisesti	['PCLE_NOPEASTI']	clit=opt
intertekstuaalisesti	['PCLE_NOPEASTI']	clit=opt
intiimisti	['PCLE_TYHMÄSTI']	clit=opt
intohimoisesti	['PCLE_NOPEASTI']	clit=opt
intohimottomasti	['PCLE_NOPEASTI']	clit=opt
intomielisesti	['PCLE_TYHMÄSTI']	clit=opt
intuitiivisesti	['PCLE_NOPEASTI']	clit=opt
ironisesti	['PCLE_NOPEASTI']	clit=opt
irrallisesti	['PCLE_NOPEASTI']	clit=opt
irrationaalisesti	['PCLE_NOPEASTI']	clit=opt
irstaasti	['PCLE_NOPEASTI']	clit=opt
irtonaisesti	['PCLE_NOPEASTI']	clit=opt
irvokkaasti	['PCLE_NOPEASTI']	clit=opt
iskevästi	['PCLE_TYHMÄSTI']	clit=opt
isosti	['PCLE_NOPEASTI']	clit=opt
istualla	['PCLE_KOTONA']	poss=opt
istualle	['PCLE_ALLE']	poss=opt
istualta	['PCLE_KOTONA']	poss=opt
isällisesti	['PCLE_TYHMÄSTI']	clit=opt
isänmaallisesti	['PCLE_NOPEASTI']	clit=opt
itarasti	['PCLE_NOPEASTI']	clit=opt
itsekeskeisesti	['PCLE_TYHMÄSTI']	clit=opt
itsekkäästi	['PCLE_TYHMÄSTI']	clit=opt
itsenäisesti	['PCLE_TYHMÄSTI']	clit=opt
itse	['PCLE_YLLE']	clit=opt
itsepintaisesti	['PCLE_NOPEASTI']	clit=opt
itse	['PRON_ITSE']	clit=opt
itsepäisesti	['PCLE_TYHMÄSTI']	clit=opt
itserakkaasti	['PCLE_NOPEASTI']	clit=opt
itseriittoisesti	['PCLE_NOPEASTI']	clit=opt
itsetietoisesti	['PCLE_NOPEASTI']	clit=opt
itsetyytyväisesti	['PCLE_TYHMÄSTI']	clit=opt
itsevaltaisesti	['PCLE_NOPEASTI']	clit=opt
itsevaltiaasti	['PCLE_NOPEASTI']	clit=opt
itsevarmasti	['PCLE_NOPEASTI']	clit=opt
ivallisesti	['PCLE_NOPEASTI']	clit=opt
iäisesti	['PCLE_TYHMÄSTI']	clit=opt
iänikuisesti	['PCLE_NOPEASTI']	clit=opt
jaetusti	['PCLE_NOPEASTI']	clit=opt
jaksoittain	['PCLE_VALTAAN']	clit=opt
jaksoittaisesti	['PCLE_NOPEASTI']	clit=opt
jalkeilla	['PCLE_KOTONA']	poss=opt
jalkeille	['PCLE_ALLE']	poss=opt
jaloissa	['PCLE_KOTONA']	poss=opt
jaloista	['PCLE_KOTONA']	poss=opt
jalomielisesti	['PCLE_TYHMÄSTI']	clit=opt
jatkuvasti	['PCLE_NOPEASTI']	clit=opt
johdonmukaisesti	['PCLE_NOPEASTI']	clit=opt
johtuen	['PCLE_VALTAAN']	clit=opt
jos	['PCLE_VUOKSI']	clit=opt
jouheasti	['PCLE_NOPEASTI']	clit=opt
joukoittain	['PCLE_VALTAAN']	clit=opt
joustavasti	['PCLE_NOPEASTI']	clit=opt
joutessa	['PCLE_KOTONA']	poss=obl
joutuisasti	['PCLE_NOPEASTI']	clit=opt
juhlallisesti	['PCLE_NOPEASTI']	clit=opt
juhlavasti	['PCLE_NOPEASTI']	clit=opt
julkeasti	['PCLE_NOPEASTI']	clit=opt
julkisesti	['PCLE_NOPEASTI']	clit=opt
julmasti	['PCLE_NOPEASTI']	clit=opt
julmetusti	['PCLE_NOPEASTI']	clit=opt
jumalaisesti	['PCLE_NOPEASTI']	clit=opt
jumalattomasti	['PCLE_NOPEASTI']	clit=opt
jumalisesti	['PCLE_NOPEASTI']	clit=opt
juoheasti	['PCLE_NOPEASTI']	clit=opt
juohevasti	['PCLE_NOPEASTI']	clit=opt
juoksevasti	['PCLE_NOPEASTI']	clit=opt
juonellisesti	['PCLE_NOPEASTI']	clit=opt
juonikkaasti	['PCLE_NOPEASTI']	clit=opt
juridisesti	['PCLE_NOPEASTI']	clit=opt
jurosti	['PCLE_NOPEASTI']	clit=opt
juurijajuuri	['PCLE_VUOKSI']	clit=opt
jyhkeästi	['PCLE_TYHMÄSTI']	clit=opt
jykevästi	['PCLE_TYHMÄSTI']	clit=opt
jylhästi	['PCLE_TYHMÄSTI']	clit=opt
jyrkästi	['PCLE_TYHMÄSTI']	clit=opt
jähmeästi	['PCLE_TYHMÄSTI']	clit=opt
jäljessä	['PCLE_IKINÄ']	poss=opt
jäljestä	['PCLE_IKINÄ']	poss=opt
jälkeen	['PCLE_NÄKYVIIN']	clit=opt
jälkeen	['PCLE_NÄKYVIIN']	poss=opt
jämerästi	['PCLE_TYHMÄSTI']	clit=opt
jämptisti	['PCLE_TYHMÄSTI']	clit=opt
jämttisti	['PCLE_TYHMÄSTI']	clit=opt
jämäkästi	['PCLE_TYHMÄSTI']	clit=opt
jännittävästi	['PCLE_TYHMÄSTI']	clit=opt
jännästi	['PCLE_TYHMÄSTI']	clit=opt
jänskästi	['PCLE_TYHMÄSTI']	clit=opt
jäntevästi	['PCLE_TYHMÄSTI']	clit=opt
järeästi	['PCLE_TYHMÄSTI']	clit=opt
järjellisesti	['PCLE_TYHMÄSTI']	clit=opt
järjestelmällisesti	['PCLE_TYHMÄSTI']	clit=opt
järjettömästi	['PCLE_TYHMÄSTI']	clit=opt
järkevästi	['PCLE_TYHMÄSTI']	clit=opt
järkiperäisesti	['PCLE_TYHMÄSTI']	clit=opt
järkkymättömästi	['PCLE_TYHMÄSTI']	clit=opt
järkyttävästi	['PCLE_TYHMÄSTI']	clit=opt
järkähtämättömästi	['PCLE_TYHMÄSTI']	clit=opt
jäyhästi	['PCLE_TYHMÄSTI']	clit=opt
jäykästi	['PCLE_TYHMÄSTI']	clit=opt
jäännöksettömästi	['PCLE_TYHMÄSTI']	clit=opt
jääräpäisesti	['PCLE_TYHMÄSTI']	clit=opt
jäätävästi	['PCLE_TYHMÄSTI']	clit=opt
kaameasti	['PCLE_NOPEASTI']	clit=opt
kaarevasti	['PCLE_NOPEASTI']	clit=opt
kaavamaisesti	['PCLE_NOPEASTI']	clit=opt
kahdenkeskisesti	['PCLE_NOPEASTI']	clit=opt
kahdesti	['PCLE_NOPEASTI']	clit=opt
kaihoisasti	['PCLE_NOPEASTI']	clit=opt
kaiketi	['PCLE_VUOKSI']	clit=opt
kaikuvasti	['PCLE_NOPEASTI']	clit=opt
kainosti	['PCLE_NOPEASTI']	clit=opt
kaksinapaisesti	['PCLE_NOPEASTI']	clit=opt
kaksinkertaisesti	['PCLE_NOPEASTI']	clit=opt
kaksittain	['PCLE_VALTAAN']	clit=opt
kalseasti	['PCLE_NOPEASTI']	clit=opt
kamalasti	['PCLE_NOPEASTI']	clit=opt
kammottavasti	['PCLE_NOPEASTI']	clit=opt
kanamaisesti	['PCLE_NOPEASTI']	clit=opt
kankeasti	['PCLE_NOPEASTI']	clit=opt
kannalla	['PCLE_KOTONA']	poss=opt
kannalle	['PCLE_ALLE']	poss=opt
kannoilla	['PCLE_KOTONA']	poss=opt
kannoille	['PCLE_ALLE']	poss=opt
kannoilta	['PCLE_KOTONA']	poss=opt
kannuittain	['PCLE_VALTAAN']	clit=opt
kansainvälisesti	['PCLE_TYHMÄSTI']	clit=opt
kansallisesti	['PCLE_NOPEASTI']	clit=opt
kansanomaisesti	['PCLE_NOPEASTI']	clit=opt
kansantajuisesti	['PCLE_NOPEASTI']	clit=opt
kansanvaltaisesti	['PCLE_NOPEASTI']	clit=opt
kanssa	['PCLE_KOTONA']	poss=opt
kantamuksittain	['PCLE_VALTAAN']	clit=opt
kaoottisesti	['PCLE_NOPEASTI']	clit=opt
kapeasti	['PCLE_NOPEASTI']	clit=opt
kapillaarisesti	['PCLE_NOPEASTI']	clit=opt
kapoittain	['PCLE_VALTAAN']	clit=opt
kappaleittain	['PCLE_VALTAAN']	clit=opt
karheasti	['PCLE_NOPEASTI']	clit=opt
karjalaisittain	['PCLE_VALTAAN']	clit=opt
karkeasti	['PCLE_NOPEASTI']	clit=opt
karmeasti	['PCLE_NOPEASTI']	clit=opt
karsaasti	['PCLE_NOPEASTI']	clit=opt
karskisti	['PCLE_NOPEASTI']	clit=opt
kartografisesti	['PCLE_NOPEASTI']	clit=opt
karusti	['PCLE_NOPEASTI']	clit=opt
karvaasti	['PCLE_NOPEASTI']	clit=opt
kasoittain	['PCLE_VALTAAN']	clit=opt
katalasti	['PCLE_NOPEASTI']	clit=opt
kategorisesti	['PCLE_NOPEASTI']	clit=opt
kateissa	['PCLE_KOTONA']	poss=obl
katkerasti	['PCLE_NOPEASTI']	clit=opt
katkonaisesti	['PCLE_NOPEASTI']	clit=opt
katsoen	['PCLE_VALTAAN']	clit=opt
katsomatta	['PCLE_KOTONA']	poss=opt
kauheasti	['PCLE_NOPEASTI']	clit=opt
kaukonäköisesti	['PCLE_TYHMÄSTI']	clit=opt
kauniisti	['PCLE_NOPEASTI']	clit=opt
kaunistelevasti	['PCLE_NOPEASTI']	clit=opt
kaunopuheisesti	['PCLE_NOPEASTI']	clit=opt
kaupallisesti	['PCLE_NOPEASTI']	clit=opt
kaupungeittain	['PCLE_VALTAAN']	clit=opt
kaupunkilaisesti	['PCLE_NOPEASTI']	clit=opt
kaupunkilaisittain	['PCLE_VALTAAN']	clit=opt
kausittain	['PCLE_VALTAAN']	clit=opt
kautta	['PCLE_KOTONA']	poss=opt
kavalasti	['PCLE_NOPEASTI']	clit=opt
kehnosti	['PCLE_NOPEASTI']	clit=opt
kehuttavasti	['PCLE_NOPEASTI']	clit=opt
keinotekoisesti	['PCLE_NOPEASTI']	clit=opt
kekseliäästi	['PCLE_TYHMÄSTI']	clit=opt
keljusti	['PCLE_NOPEASTI']	clit=opt
kelvollisesti	['PCLE_NOPEASTI']	clit=opt
kelvottomasti	['PCLE_NOPEASTI']	clit=opt
kemiallisesti	['PCLE_NOPEASTI']	clit=opt
kepeästi	['PCLE_TYHMÄSTI']	clit=opt
kepulisti	['PCLE_NOPEASTI']	clit=opt
keralla	['PCLE_KOTONA']	poss=opt
keralle	['PCLE_ALLE']	poss=opt
kerkeästi	['PCLE_TYHMÄSTI']	clit=opt
kernaasti	['PCLE_NOPEASTI']	clit=opt
kerroksittain	['PCLE_VALTAAN']	clit=opt
-kertaisesti	['PCLE_NOPEASTI']	clit=opt
kertakaikkisesti	['PCLE_NOPEASTI']	clit=opt
keskeen	['PCLE_NÄKYVIIN']	poss=opt
keskeisesti	['PCLE_TYHMÄSTI']	clit=opt
keskelle	['PCLE_YLLE']	poss=opt
keskellä	['PCLE_IKINÄ']	poss=opt
keskeltä	['PCLE_IKINÄ']	poss=opt
kesken	['PCLE_NÄKYVIIN']	poss=opt
keskessä	['PCLE_IKINÄ']	poss=opt
keskestä	['PCLE_IKINÄ']	poss=opt
keskihakuisesti	['PCLE_NOPEASTI']	clit=opt
keskimääräisesti	['PCLE_TYHMÄSTI']	clit=opt
keskinkertaisesti	['PCLE_NOPEASTI']	clit=opt
keskinäisesti	['PCLE_TYHMÄSTI']	clit=opt
keskipakoisesti	['PCLE_NOPEASTI']	clit=opt
keskuudessa	['PCLE_KOTONA']	poss=opt
keskuudesta	['PCLE_KOTONA']	poss=opt
keskuuteen	['PCLE_VALTAAN']	poss=opt
kestävästi	['PCLE_TYHMÄSTI']	clit=opt
kesysti	['PCLE_TYHMÄSTI']	clit=opt
kesäisesti	['PCLE_TYHMÄSTI']	clit=opt
ketterästi	['PCLE_TYHMÄSTI']	clit=opt
keveästi	['PCLE_TYHMÄSTI']	clit=opt
kevyesti	['PCLE_TYHMÄSTI']	clit=opt
kevytmielisesti	['PCLE_TYHMÄSTI']	clit=opt
keväisesti	['PCLE_TYHMÄSTI']	clit=opt
kiehtovasti	['PCLE_NOPEASTI']	clit=opt
kielellisesti	['PCLE_TYHMÄSTI']	clit=opt
kielevästi	['PCLE_TYHMÄSTI']	clit=opt
kieliopillisesti	['PCLE_NOPEASTI']	clit=opt
kielteisesti	['PCLE_TYHMÄSTI']	clit=opt
kierosti	['PCLE_NOPEASTI']	clit=opt
kierroksittain	['PCLE_VALTAAN']	clit=opt
kierteisesti	['PCLE_TYHMÄSTI']	clit=opt
kiihdyksiin	['PCLE_NÄKYVIIN']	poss=opt
kiihdyksissä	['PCLE_IKINÄ']	poss=opt
kiihkeästi	['PCLE_TYHMÄSTI']	clit=opt
kiihkoisasti	['PCLE_NOPEASTI']	clit=opt
kiihkottomasti	['PCLE_NOPEASTI']	clit=opt
kiinnostavasti	['PCLE_NOPEASTI']	clit=opt
kiinteästi	['PCLE_TYHMÄSTI']	clit=opt
kiintoisasti	['PCLE_NOPEASTI']	clit=opt
kiireellisesti	['PCLE_TYHMÄSTI']	clit=opt
kiireesti	['PCLE_TYHMÄSTI']	clit=opt
kiireettömästi	['PCLE_TYHMÄSTI']	clit=opt
kiireisesti	['PCLE_TYHMÄSTI']	clit=opt
kiiruusti	['PCLE_NOPEASTI']	clit=opt
kiistattomasti	['PCLE_NOPEASTI']	clit=opt
kiistämättömästi	['PCLE_TYHMÄSTI']	clit=opt
kiitettävästi	['PCLE_TYHMÄSTI']	clit=opt
kiittämättömästi	['PCLE_TYHMÄSTI']	clit=opt
kiivaasti	['PCLE_NOPEASTI']	clit=opt
kiloittain	['PCLE_VALTAAN']	clit=opt
kilometreittäin	['PCLE_NÄKYVIIN']	clit=opt
kiltisti	['PCLE_TYHMÄSTI']	clit=opt
kimakasti	['PCLE_NOPEASTI']	clit=opt
kimeästi	['PCLE_TYHMÄSTI']	clit=opt
kimmoisasti	['PCLE_NOPEASTI']	clit=opt
kimppuun	['PCLE_VALTAAN']	poss=opt
kimpuittain	['PCLE_VALTAAN']	clit=opt
kintereille	['PCLE_YLLE']	poss=opt
kintereillä	['PCLE_IKINÄ']	poss=opt
kintereiltä	['PCLE_IKINÄ']	poss=opt
kipakasti	['PCLE_NOPEASTI']	clit=opt
kiperästi	['PCLE_TYHMÄSTI']	clit=opt
kipeästi	['PCLE_TYHMÄSTI']	clit=opt
kireästi	['PCLE_TYHMÄSTI']	clit=opt
kirjaimellisesti	['PCLE_NOPEASTI']	clit=opt
kirjallisesti	['PCLE_NOPEASTI']	clit=opt
kirjanpidollisesti	['PCLE_NOPEASTI']	clit=opt
kirjavasti	['PCLE_NOPEASTI']	clit=opt
kirjeellisesti	['PCLE_TYHMÄSTI']	clit=opt
kirkkaasti	['PCLE_NOPEASTI']	clit=opt
kirkollisesti	['PCLE_NOPEASTI']	clit=opt
kirotusti	['PCLE_NOPEASTI']	clit=opt
kirpeästi	['PCLE_TYHMÄSTI']	clit=opt
kirurgisesti	['PCLE_NOPEASTI']	clit=opt
kitkattomasti	['PCLE_NOPEASTI']	clit=opt
kitkerästi	['PCLE_TYHMÄSTI']	clit=opt
kitsaasti	['PCLE_NOPEASTI']	clit=opt
kituliaasti	['PCLE_NOPEASTI']	clit=opt
kiukkuisesti	['PCLE_NOPEASTI']	clit=opt
kiusallisesti	['PCLE_NOPEASTI']	clit=opt
kivasti	['PCLE_NOPEASTI']	clit=opt
kiverästi	['PCLE_TYHMÄSTI']	clit=opt
kivuliaasti	['PCLE_NOPEASTI']	clit=opt
kivuttomasti	['PCLE_NOPEASTI']	clit=opt
klassisesti	['PCLE_NOPEASTI']	clit=opt
kliinisesti	['PCLE_TYHMÄSTI']	clit=opt
kodikkaasti	['PCLE_NOPEASTI']	clit=opt
kohdittain	['PCLE_VALTAAN']	clit=opt
koholla	['PCLE_KOTONA']	poss=opt
koholle	['PCLE_ALLE']	poss=opt
kohtaan	['PCLE_VALTAAN']	poss=opt
-kohtaisesti	['PCLE_NOPEASTI']	clit=opt
kohtalaisesti	['PCLE_NOPEASTI']	clit=opt
kohtalokkaasti	['PCLE_NOPEASTI']	clit=opt
kohtauksittain	['PCLE_VALTAAN']	clit=opt
kohteliaasti	['PCLE_NOPEASTI']	clit=opt
kohtisuorasti	['PCLE_NOPEASTI']	clit=opt
kohtuullisesti	['PCLE_NOPEASTI']	clit=opt
kohtuuttomasti	['PCLE_NOPEASTI']	clit=opt
kokeellisesti	['PCLE_NOPEASTI']	clit=opt
kokemusperäisesti	['PCLE_TYHMÄSTI']	clit=opt
kokeneesti	['PCLE_NOPEASTI']	clit=opt
kokonaisvaltaisesti	['PCLE_NOPEASTI']	clit=opt
koleasti	['PCLE_NOPEASTI']	clit=opt
kolkosti	['PCLE_NOPEASTI']	clit=opt
kollektiivisesti	['PCLE_NOPEASTI']	clit=opt
kolmasti	['PCLE_NOPEASTI']	clit=opt
kolmesti	['PCLE_NOPEASTI']	clit=opt
kolminkertaisesti	['PCLE_NOPEASTI']	clit=opt
kolmittain	['PCLE_VALTAAN']	clit=opt
kolmiäänisesti	['PCLE_TYHMÄSTI']	clit=opt
komeasti	['PCLE_NOPEASTI']	clit=opt
koneellisesti	['PCLE_NOPEASTI']	clit=opt
konemaisesti	['PCLE_NOPEASTI']	clit=opt
konkreettisesti	['PCLE_NOPEASTI']	clit=opt
konservatiivisesti	['PCLE_NOPEASTI']	clit=opt
konstikkaasti	['PCLE_NOPEASTI']	clit=opt
koomisesti	['PCLE_NOPEASTI']	clit=opt
kopeasti	['PCLE_NOPEASTI']	clit=opt
koppavasti	['PCLE_NOPEASTI']	clit=opt
koreasti	['PCLE_NOPEASTI']	clit=opt
koreittain	['PCLE_VALTAAN']	clit=opt
koristeellisesti	['PCLE_NOPEASTI']	clit=opt
korjaamattomasti	['PCLE_NOPEASTI']	clit=opt
korkeasti	['PCLE_NOPEASTI']	clit=opt
korkeintaan	['PCLE_VALTAAN']	clit=opt
korosteisesti	['PCLE_NOPEASTI']	clit=opt
korrektisti	['PCLE_NOPEASTI']	clit=opt
korskeasti	['PCLE_NOPEASTI']	clit=opt
koruttomasti	['PCLE_NOPEASTI']	clit=opt
koskien	['PCLE_VALTAAN']	clit=opt
kosteasti	['PCLE_NOPEASTI']	clit=opt
kotia	['PCLE_KOTONA']	poss=opt
kotoa	['PCLE_KOTONA']	poss=opt
kotoisesti	['PCLE_NOPEASTI']	clit=opt
kotona	['PCLE_KOTONA']	poss=opt
kouraantuntuvasti	['PCLE_NOPEASTI']	clit=opt
kouriintuntuvasti	['PCLE_NOPEASTI']	clit=opt
kourissa	['PCLE_KOTONA']	poss=opt
kourista	['PCLE_KOTONA']	poss=opt
kouristuksenomaisesti	['PCLE_NOPEASTI']	clit=opt
kovakouraisesti	['PCLE_NOPEASTI']	clit=opt
kovakätisesti	['PCLE_TYHMÄSTI']	clit=opt
kovasti	['PCLE_NOPEASTI']	clit=opt
kovasydämisesti	['PCLE_TYHMÄSTI']	clit=opt
kovaäänisesti	['PCLE_TYHMÄSTI']	clit=opt
kriittisesti	['PCLE_TYHMÄSTI']	clit=opt
kristallinkirkkaasti	['PCLE_NOPEASTI']	clit=opt
kristillisesti	['PCLE_TYHMÄSTI']	clit=opt
kritiikittömästi	['PCLE_TYHMÄSTI']	clit=opt
kronologisesti	['PCLE_NOPEASTI']	clit=opt
kroonisesti	['PCLE_NOPEASTI']	clit=opt
kuivakiskoisesti	['PCLE_NOPEASTI']	clit=opt
kuivasti	['PCLE_NOPEASTI']	clit=opt
kuivilla	['PCLE_KOTONA']	poss=opt
kuiville	['PCLE_ALLE']	poss=opt
kujeellisesti	['PCLE_NOPEASTI']	clit=opt
kulauksittain	['PCLE_VALTAAN']	clit=opt
kulmikkaasti	['PCLE_NOPEASTI']	clit=opt
kulmittain	['PCLE_VALTAAN']	clit=opt
kultaisesti	['PCLE_NOPEASTI']	clit=opt
kulttuurisesti	['PCLE_NOPEASTI']	clit=opt
kuluessa	['PCLE_KOTONA']	clit=opt
kuluessa	['PCLE_KOTONA']	poss=opt
kuluttua	['PCLE_KOTONA']	clit=opt
kuluttua	['PCLE_KOTONA']	poss=opt
kumeasti	['PCLE_NOPEASTI']	clit=opt
kummallisesti	['PCLE_NOPEASTI']	clit=opt
kummasti	['PCLE_NOPEASTI']	clit=opt
kumoamattomasti	['PCLE_NOPEASTI']	clit=opt
kuninkaallisesti	['PCLE_NOPEASTI']	clit=opt
kunniakkaasti	['PCLE_NOPEASTI']	clit=opt
kunniallisesti	['PCLE_NOPEASTI']	clit=opt
kunnianhimoisesti	['PCLE_NOPEASTI']	clit=opt
kunniattomasti	['PCLE_NOPEASTI']	clit=opt
kunnioitettavasti	['PCLE_NOPEASTI']	clit=opt
kunnioittavasti	['PCLE_NOPEASTI']	clit=opt
kunnittain	['PCLE_VALTAAN']	clit=opt
kunnollisesti	['PCLE_NOPEASTI']	clit=opt
kuohuksiin	['PCLE_VALTAAN']	poss=opt
kuohuksissa	['PCLE_KOTONA']	poss=opt
kuolemanvakavasti	['PCLE_NOPEASTI']	clit=opt
kuolettavasti	['PCLE_NOPEASTI']	clit=opt
kuormittain	['PCLE_VALTAAN']	clit=opt
kupeella	['PCLE_KOTONA']	poss=opt
kupeelle	['PCLE_ALLE']	poss=opt
kupeelta	['PCLE_KOTONA']	poss=opt
kurillisesti	['PCLE_NOPEASTI']	clit=opt
kurittomasti	['PCLE_NOPEASTI']	clit=opt
kurjasti	['PCLE_NOPEASTI']	clit=opt
kursorisesti	['PCLE_NOPEASTI']	clit=opt
kustannuksella	['PCLE_KOTONA']	poss=opt
kuti	['N_TAUTI']	poss=obl
kuti	['PCLE_VUOKSI']	poss=obl
kuudesti	['PCLE_NOPEASTI']	clit=opt
kuukausittain	['PCLE_VALTAAN']	clit=opt
kuuliaisesti	['PCLE_NOPEASTI']	clit=opt
kuultavasti	['PCLE_NOPEASTI']	clit=opt
kuulumattomasti	['PCLE_NOPEASTI']	clit=opt
kuuluvasti	['PCLE_NOPEASTI']	clit=opt
kuumasti	['PCLE_NOPEASTI']	clit=opt
kuumaverisesti	['PCLE_TYHMÄSTI']	clit=opt
kuumeisesti	['PCLE_NOPEASTI']	clit=opt
kuuroittain	['PCLE_VALTAAN']	clit=opt
kuutioittain	['PCLE_VALTAAN']	clit=opt
kuutiollisesti	['PCLE_NOPEASTI']	clit=opt
kuutiomaisesti	['PCLE_NOPEASTI']	clit=opt
kuutiometreittäin	['PCLE_NÄKYVIIN']	clit=opt
kuvaamattomasti	['PCLE_NOPEASTI']	clit=opt
kuvaannollisesti	['PCLE_NOPEASTI']	clit=opt
kuvallisesti	['PCLE_NOPEASTI']	clit=opt
kvalitatiivisesti	['PCLE_NOPEASTI']	clit=opt
kvantitatiivisesti	['PCLE_NOPEASTI']	clit=opt
kyljittäin	['PCLE_NÄKYVIIN']	clit=opt
kylliksi	['PCLE_LISÄKSI']	poss=opt
kyllin	['PCLE_NÄKYVIIN']	clit=opt
kylmäkiskoisesti	['PCLE_NOPEASTI']	clit=opt
kylmäpäisesti	['PCLE_TYHMÄSTI']	clit=opt
kylmästi	['PCLE_TYHMÄSTI']	clit=opt
kylmäsydämisesti	['PCLE_TYHMÄSTI']	clit=opt
kylmäverisesti	['PCLE_TYHMÄSTI']	clit=opt
kymmenesti	['PCLE_TYHMÄSTI']	clit=opt
kymmenittäin	['PCLE_NÄKYVIIN']	clit=opt
kynsissä	['PCLE_IKINÄ']	poss=opt
kynsistä	['PCLE_IKINÄ']	poss=opt
kypsästi	['PCLE_TYHMÄSTI']	clit=opt
kysyvästi	['PCLE_TYHMÄSTI']	clit=opt
kyynisesti	['PCLE_TYHMÄSTI']	clit=opt
käheästi	['PCLE_TYHMÄSTI']	clit=opt
käheä-äänisesti	['PCLE_TYHMÄSTI']	clit=opt
kärjekkäästi	['PCLE_TYHMÄSTI']	clit=opt
kärkevästi	['PCLE_TYHMÄSTI']	clit=opt
kärkkäästi	['PCLE_TYHMÄSTI']	clit=opt
kärsimättömästi	['PCLE_TYHMÄSTI']	clit=opt
kärsivällisesti	['PCLE_TYHMÄSTI']	clit=opt
kärttyisästi	['PCLE_TYHMÄSTI']	clit=opt
käsin	['PCLE_NÄKYVIIN']	clit=opt
käsiteollisesti	['PCLE_NOPEASTI']	clit=opt
käsitteellisesti	['PCLE_TYHMÄSTI']	clit=opt
käsittämättömästi	['PCLE_TYHMÄSTI']	clit=opt
käsivaraisesti	['PCLE_NOPEASTI']	clit=opt
kätevästi	['PCLE_TYHMÄSTI']	clit=opt
-kätisesti	['PCLE_TYHMÄSTI']	clit=opt
käymäseltä	['PCLE_IKINÄ']	poss=opt
käytännöllisesti	['PCLE_TYHMÄSTI']	clit=opt
käyvästi	['PCLE_TYHMÄSTI']	clit=opt
käänteentekevästi	['PCLE_TYHMÄSTI']	clit=opt
käänteisesti	['PCLE_TYHMÄSTI']	clit=opt
kömpelösti	['PCLE_TYHMÄSTI']	clit=opt
köniin	['PCLE_NÄKYVIIN']	poss=opt
köpelösti	['PCLE_TYHMÄSTI']	clit=opt
köyhästi	['PCLE_TYHMÄSTI']	clit=opt
köykäisesti	['PCLE_TYHMÄSTI']	clit=opt
laadukkaasti	['PCLE_NOPEASTI']	clit=opt
laadullisesti	['PCLE_NOPEASTI']	clit=opt
laaja-alaisesti	['PCLE_NOPEASTI']	clit=opt
laajasti	['PCLE_NOPEASTI']	clit=opt
laatuunkäyvästi	['PCLE_TYHMÄSTI']	clit=opt
labiilisti	['PCLE_NOPEASTI']	clit=opt
lahjakkaasti	['PCLE_NOPEASTI']	clit=opt
lahjomattomasti	['PCLE_NOPEASTI']	clit=opt
laidalla	['PCLE_KOTONA']	poss=opt
laidalle	['PCLE_ALLE']	poss=opt
laidalta	['PCLE_KOTONA']	poss=opt
laidassa	['PCLE_KOTONA']	poss=opt
laidasta	['PCLE_KOTONA']	poss=opt
laikuittain	['PCLE_VALTAAN']	clit=opt
lailla	['PCLE_KOTONA']	poss=opt
laillisesti	['PCLE_NOPEASTI']	clit=opt
lainmukaisesti	['PCLE_NOPEASTI']	clit=opt
lainvastaisesti	['PCLE_NOPEASTI']	clit=opt
laiskasti	['PCLE_NOPEASTI']	clit=opt
laitaan	['PCLE_VALTAAN']	clit=opt
laittamattomasti	['PCLE_NOPEASTI']	clit=opt
laittomasti	['PCLE_NOPEASTI']	clit=opt
lakimääräisesti	['PCLE_TYHMÄSTI']	clit=opt
lakonisesti	['PCLE_NOPEASTI']	clit=opt
lammasmaisesti	['PCLE_NOPEASTI']	clit=opt
lapsekkaasti	['PCLE_NOPEASTI']	clit=opt
lapsellisesti	['PCLE_NOPEASTI']	clit=opt
lapsenomaisesti	['PCLE_NOPEASTI']	clit=opt
lapsentajuisesti	['PCLE_NOPEASTI']	clit=opt
laseittain	['PCLE_VALTAAN']	clit=opt
laskematta	['PCLE_KOTONA']	poss=opt
laskennallisesti	['PCLE_NOPEASTI']	clit=opt
latteasti	['PCLE_NOPEASTI']	clit=opt
lauhkeasti	['PCLE_NOPEASTI']	clit=opt
laulavasti	['PCLE_NOPEASTI']	clit=opt
laumoittain	['PCLE_VALTAAN']	clit=opt
laupiaasti	['PCLE_NOPEASTI']	clit=opt
laveasanaisesti	['PCLE_NOPEASTI']	clit=opt
laveasti	['PCLE_NOPEASTI']	clit=opt
leikillisesti	['PCLE_TYHMÄSTI']	clit=opt
leikisti	['PCLE_TYHMÄSTI']	clit=opt
leikkisästi	['PCLE_TYHMÄSTI']	clit=opt
lemmekkäästi	['PCLE_TYHMÄSTI']	clit=opt
lempeästi	['PCLE_TYHMÄSTI']	clit=opt
lennokkaasti	['PCLE_NOPEASTI']	clit=opt
leppeästi	['PCLE_TYHMÄSTI']	clit=opt
leppoisasti	['PCLE_NOPEASTI']	clit=opt
leppymättömästi	['PCLE_TYHMÄSTI']	clit=opt
lepsusti	['PCLE_NOPEASTI']	clit=opt
lerpalla	['PCLE_KOTONA']	poss=opt
lerpalle	['PCLE_ALLE']	poss=opt
letkeästi	['PCLE_TYHMÄSTI']	clit=opt
leudosti	['PCLE_NOPEASTI']	clit=opt
leuhkasti	['PCLE_NOPEASTI']	clit=opt
leukavasti	['PCLE_NOPEASTI']	clit=opt
leveästi	['PCLE_TYHMÄSTI']	clit=opt
levollisesti	['PCLE_NOPEASTI']	clit=opt
levottomasti	['PCLE_NOPEASTI']	clit=opt
leväperäisesti	['PCLE_TYHMÄSTI']	clit=opt
liberaalisesti	['PCLE_NOPEASTI']	clit=opt
liberaalisti	['PCLE_NOPEASTI']	clit=opt
liehakkaasti	['PCLE_NOPEASTI']	clit=opt
lievästi	['PCLE_TYHMÄSTI']	clit=opt
liiketaloudellisesti	['PCLE_NOPEASTI']	clit=opt
liikkuvasti	['PCLE_NOPEASTI']	clit=opt
liikuttavasti	['PCLE_NOPEASTI']	clit=opt
likeisesti	['PCLE_TYHMÄSTI']	clit=opt
likelle	['PCLE_YLLE']	poss=opt
likellä	['PCLE_IKINÄ']	poss=opt
likeltä	['PCLE_IKINÄ']	poss=opt
likimääräisesti	['PCLE_TYHMÄSTI']	clit=opt
limittäin	['PCLE_NÄKYVIIN']	clit=opt
linjakkaasti	['PCLE_NOPEASTI']	clit=opt
lipettiin	['PCLE_NÄKYVIIN']	clit=opt
lipevästi	['PCLE_TYHMÄSTI']	clit=opt
lisäksi	['PCLE_LIKI']	clit=opt
lisäksi	['PCLE_LISÄKSI']	clit=opt
litroittain	['PCLE_VALTAAN']	clit=opt
liukkaasti	['PCLE_NOPEASTI']	clit=opt
liukuvasti	['PCLE_NOPEASTI']	clit=opt
lohduttomasti	['PCLE_NOPEASTI']	clit=opt
loistavasti	['PCLE_NOPEASTI']	clit=opt
loisteliaasti	['PCLE_NOPEASTI']	clit=opt
loivasti	['PCLE_NOPEASTI']	clit=opt
lojaalisesti	['PCLE_NOPEASTI']	clit=opt
lojaalisti	['PCLE_NOPEASTI']	clit=opt
lokaalisesti	['PCLE_NOPEASTI']	clit=opt
lokoisasti	['PCLE_NOPEASTI']	clit=opt
lomitse	['PCLE_ALLE']	poss=opt
lomittain	['PCLE_VALTAAN']	clit=opt
loogisesti	['PCLE_NOPEASTI']	clit=opt
loppumattomasti	['PCLE_NOPEASTI']	clit=opt
lopulla	['PCLE_KOTONA']	poss=opt
lopullisesti	['PCLE_NOPEASTI']	clit=opt
lopulta	['PCLE_KOTONA']	clit=opt
loputtomasti	['PCLE_NOPEASTI']	clit=opt
luihusti	['PCLE_NOPEASTI']	clit=opt
lujakätisesti	['PCLE_TYHMÄSTI']	clit=opt
lujasti	['PCLE_NOPEASTI']	clit=opt
lukuisasti	['PCLE_NOPEASTI']	clit=opt
lukumääräisesti	['PCLE_TYHMÄSTI']	clit=opt
lukuun ottamatta	['PCLE_KOTONA']	clit=opt
lukuun ottamatta	['PCLE_KOTONA']	poss=opt
lunkisti	['PCLE_NOPEASTI']	clit=opt
luokse	['PCLE_ALLE']	poss=opt
luona	['PCLE_KOTONA']	poss=opt
luonnikkaasti	['PCLE_NOPEASTI']	clit=opt
luonnollisesti	['PCLE_NOPEASTI']	clit=opt
luonnonmukaisesti	['PCLE_NOPEASTI']	clit=opt
luonnottomasti	['PCLE_NOPEASTI']	clit=opt
luontaisesti	['PCLE_NOPEASTI']	clit=opt
luonteenomaisesti	['PCLE_NOPEASTI']	clit=opt
luonteisesti	['PCLE_NOPEASTI']	clit=opt
luontevasti	['PCLE_NOPEASTI']	clit=opt
luotaantyöntävästi	['PCLE_TYHMÄSTI']	clit=opt
luota	['PCLE_KOTONA']	poss=opt
luotettavasti	['PCLE_NOPEASTI']	clit=opt
luottamuksellisesti	['PCLE_NOPEASTI']	clit=opt
luottavaisesti	['PCLE_NOPEASTI']	clit=opt
luovasti	['PCLE_NOPEASTI']	clit=opt
lupaavasti	['PCLE_NOPEASTI']	clit=opt
lupsakasti	['PCLE_NOPEASTI']	clit=opt
lupsakkaasti	['PCLE_NOPEASTI']	clit=opt
lurjusmaisesti	['PCLE_NOPEASTI']	clit=opt
lurpalla	['PCLE_KOTONA']	poss=opt
lurpalle	['PCLE_ALLE']	poss=opt
luultavasti	['PCLE_NOPEASTI']	clit=opt
luvalla	['PCLE_KOTONA']	poss=opt
luvallisesti	['PCLE_NOPEASTI']	clit=opt
luvattomasti	['PCLE_NOPEASTI']	clit=opt
luvuttomasti	['PCLE_NOPEASTI']	clit=opt
lyhyesti	['PCLE_TYHMÄSTI']	clit=opt
lyhykäisesti	['PCLE_TYHMÄSTI']	clit=opt
lyhytjännitteisesti	['PCLE_TYHMÄSTI']	clit=opt
lyhytjänteisesti	['PCLE_TYHMÄSTI']	clit=opt
lyhytnäköisesti	['PCLE_TYHMÄSTI']	clit=opt
lyhytsanaisesti	['PCLE_NOPEASTI']	clit=opt
lystikkäästi	['PCLE_TYHMÄSTI']	clit=opt
lyyrisesti	['PCLE_TYHMÄSTI']	clit=opt
läheisesti	['PCLE_TYHMÄSTI']	clit=opt
lähelle	['PCLE_YLLE']	poss=opt
lähellä	['PCLE_IKINÄ']	poss=opt
läheltä	['PCLE_IKINÄ']	poss=opt
lähettyville	['PCLE_YLLE']	poss=opt
lähettyvillä	['PCLE_IKINÄ']	poss=obl
lähettyviltä	['PCLE_IKINÄ']	poss=opt
lähtemättömästi	['PCLE_TYHMÄSTI']	clit=opt
lähtien	['PCLE_NÄKYVIIN']	clit=opt
läjittäin	['PCLE_NÄKYVIIN']	clit=opt
läkähdyksiin	['PCLE_NÄKYVIIN']	poss=opt
läkähdyksissä	['PCLE_IKINÄ']	poss=opt
lämpimästi	['PCLE_TYHMÄSTI']	clit=opt
lämpöisesti	['PCLE_TYHMÄSTI']	clit=opt
länsimaisesti	['PCLE_NOPEASTI']	clit=opt
läpikotaisesti	['PCLE_NOPEASTI']	clit=opt
läpitunkevasti	['PCLE_NOPEASTI']	clit=opt
lävitse	['PCLE_YLLE']	poss=opt
lääketieteellisesti	['PCLE_TYHMÄSTI']	clit=opt
lääneittäin	['PCLE_NÄKYVIIN']	clit=opt
löperösti	['PCLE_TYHMÄSTI']	clit=opt
löyhästi	['PCLE_TYHMÄSTI']	clit=opt
löysästi	['PCLE_TYHMÄSTI']	clit=opt
maagisesti	['PCLE_NOPEASTI']	clit=opt
maailmanhistoriallisesti	['PCLE_NOPEASTI']	clit=opt
maailmanlaajuisesti	['PCLE_NOPEASTI']	clit=opt
maalaisesti	['PCLE_NOPEASTI']	clit=opt
maalaisittain	['PCLE_VALTAAN']	clit=opt
maalaismaisesti	['PCLE_NOPEASTI']	clit=opt
maalauksellisesti	['PCLE_NOPEASTI']	clit=opt
maantieteellisesti	['PCLE_TYHMÄSTI']	clit=opt
magneettisesti	['PCLE_NOPEASTI']	clit=opt
mahdikkaasti	['PCLE_NOPEASTI']	clit=opt
mahdollisesti	['PCLE_NOPEASTI']	clit=opt
mahdottomasti	['PCLE_NOPEASTI']	clit=opt
mahtailevasti	['PCLE_NOPEASTI']	clit=opt
mahtavasti	['PCLE_NOPEASTI']	clit=opt
mahtipontisesti	['PCLE_NOPEASTI']	clit=opt
maineikkaasti	['PCLE_NOPEASTI']	clit=opt
mainittavasti	['PCLE_NOPEASTI']	clit=opt
mainonnallisesti	['PCLE_NOPEASTI']	clit=opt
maireasti	['PCLE_NOPEASTI']	clit=opt
mairittelevasti	['PCLE_NOPEASTI']	clit=opt
maittain	['PCLE_VALTAAN']	clit=opt
majesteettisesti	['PCLE_NOPEASTI']	clit=opt
makeasti	['PCLE_NOPEASTI']	clit=opt
maksuttomasti	['PCLE_NOPEASTI']	clit=opt
makuulla	['PCLE_KOTONA']	poss=opt
makuulle	['PCLE_ALLE']	poss=opt
makuulta	['PCLE_KOTONA']	poss=opt
mallikelpoisesti	['PCLE_NOPEASTI']	clit=opt
mallikkaasti	['PCLE_NOPEASTI']	clit=opt
maltillisesti	['PCLE_NOPEASTI']	clit=opt
maltittomasti	['PCLE_NOPEASTI']	clit=opt
malttamattomasti	['PCLE_NOPEASTI']	clit=opt
maneerimaisesti	['PCLE_NOPEASTI']	clit=opt
mannermaisesti	['PCLE_NOPEASTI']	clit=opt
manuaalisesti	['PCLE_NOPEASTI']	clit=opt
markkamääräisesti	['PCLE_TYHMÄSTI']	clit=opt
masentuneesti	['PCLE_NOPEASTI']	clit=opt
masokistisesti	['PCLE_NOPEASTI']	clit=opt
massiivisesti	['PCLE_NOPEASTI']	clit=opt
massoittain	['PCLE_VALTAAN']	clit=opt
matalamielisesti	['PCLE_TYHMÄSTI']	clit=opt
matelevasti	['PCLE_NOPEASTI']	clit=opt
materialistisesti	['PCLE_NOPEASTI']	clit=opt
matkailullisesti	['PCLE_NOPEASTI']	clit=opt
maukkaasti	['PCLE_NOPEASTI']	clit=opt
mauttomasti	['PCLE_NOPEASTI']	clit=opt
mehevästi	['PCLE_TYHMÄSTI']	clit=opt
mehukkaasti	['PCLE_NOPEASTI']	clit=opt
meikäläisittäin	['PCLE_NÄKYVIIN']	clit=opt
mekaanisesti	['PCLE_NOPEASTI']	clit=opt
melankolisesti	['PCLE_NOPEASTI']	clit=opt
melkoisesti	['PCLE_NOPEASTI']	clit=opt
melodisesti	['PCLE_NOPEASTI']	clit=opt
melodramaattisesti	['PCLE_NOPEASTI']	clit=opt
meluisasti	['PCLE_NOPEASTI']	clit=opt
menehdyksiin	['PCLE_NÄKYVIIN']	poss=opt
menehdyksissä	['PCLE_IKINÄ']	poss=opt
meneillä	['PCLE_IKINÄ']	poss=opt
menestyksekkäästi	['PCLE_TYHMÄSTI']	clit=opt
menestyksellisesti	['PCLE_TYHMÄSTI']	clit=opt
mennessä	['PCLE_IKINÄ']	clit=opt
mentaalisesti	['PCLE_NOPEASTI']	clit=opt
merisotilaallisesti	['PCLE_NOPEASTI']	clit=opt
merkillisesti	['PCLE_TYHMÄSTI']	clit=opt
merkitsevästi	['PCLE_TYHMÄSTI']	clit=opt
merkittävästi	['PCLE_TYHMÄSTI']	clit=opt
mestarillisesti	['PCLE_NOPEASTI']	clit=opt
metaforisesti	['PCLE_NOPEASTI']	clit=opt
metkasti	['PCLE_NOPEASTI']	clit=opt
metodisesti	['PCLE_NOPEASTI']	clit=opt
metreittäin	['PCLE_NÄKYVIIN']	clit=opt
metsänhoidollisesti	['PCLE_NOPEASTI']	clit=opt
miedosti	['PCLE_NOPEASTI']	clit=opt
miehekkäästi	['PCLE_TYHMÄSTI']	clit=opt
miehevästi	['PCLE_TYHMÄSTI']	clit=opt
miehuullisesti	['PCLE_NOPEASTI']	clit=opt
mielekkäästi	['PCLE_TYHMÄSTI']	clit=opt
mielenkiinnottomasti	['PCLE_NOPEASTI']	clit=opt
mielenkiintoisesti	['PCLE_NOPEASTI']	clit=opt
mielenosoituksellisesti	['PCLE_NOPEASTI']	clit=opt
mielenterveydellisesti	['PCLE_TYHMÄSTI']	clit=opt
mielestä	['PCLE_IKINÄ']	poss=opt
mielettömästi	['PCLE_TYHMÄSTI']	clit=opt
mielevästi	['PCLE_TYHMÄSTI']	clit=opt
mieliksi	['PCLE_LISÄKSI']	poss=opt
mielikuvituksekkaasti	['PCLE_NOPEASTI']	clit=opt
mielipuolisesti	['PCLE_NOPEASTI']	clit=opt
-mielisesti	['PCLE_TYHMÄSTI']	clit=opt
mielivaltaisesti	['PCLE_NOPEASTI']	clit=opt
miellyttävästi	['PCLE_TYHMÄSTI']	clit=opt
mieluisasti	['PCLE_NOPEASTI']	clit=opt
mieluisesti	['PCLE_NOPEASTI']	clit=opt
mieluusti	['PCLE_NOPEASTI']	clit=opt
mieskohtaisesti	['PCLE_NOPEASTI']	clit=opt
mieslukuisesti	['PCLE_NOPEASTI']	clit=opt
miesmäisesti	['PCLE_TYHMÄSTI']	clit=opt
mietteliäästi	['PCLE_TYHMÄSTI']	clit=opt
miettiväisesti	['PCLE_TYHMÄSTI']	clit=opt
miimisesti	['PCLE_TYHMÄSTI']	clit=opt
mikroskooppisesti	['PCLE_NOPEASTI']	clit=opt
miljoonittain	['PCLE_VALTAAN']	clit=opt
minuuteittain	['PCLE_VALTAAN']	clit=opt
mittaamattomasti	['PCLE_NOPEASTI']	clit=opt
modernisti	['N_RUUVI']	clit=opt
modernisti	['PCLE_NOPEASTI']	clit=opt
moitittavasti	['PCLE_NOPEASTI']	clit=opt
moitteettomasti	['PCLE_NOPEASTI']	clit=opt
moittivasti	['PCLE_NOPEASTI']	clit=opt
molemminpuolisesti	['PCLE_NOPEASTI']	clit=opt
monasti	['PCLE_NOPEASTI']	clit=opt
monesti	['PCLE_NOPEASTI']	clit=opt
monilukuisesti	['PCLE_NOPEASTI']	clit=opt
monimielisesti	['PCLE_NOPEASTI']	clit=opt
moninkertaisesti	['PCLE_NOPEASTI']	clit=opt
monipuolisesti	['PCLE_NOPEASTI']	clit=opt
monisanaisesti	['PCLE_NOPEASTI']	clit=opt
monisatakertaisesti	['PCLE_NOPEASTI']	clit=opt
monituhatkertaisesti	['PCLE_NOPEASTI']	clit=opt
monotonisesti	['PCLE_NOPEASTI']	clit=opt
monumentaalisesti	['PCLE_NOPEASTI']	clit=opt
moraalisesti	['PCLE_NOPEASTI']	clit=opt
moraalittomasti	['PCLE_NOPEASTI']	clit=opt
moukkamaisesti	['PCLE_NOPEASTI']	clit=opt
muassa	['PCLE_KOTONA']	poss=opt
muhkeasti	['PCLE_NOPEASTI']	clit=opt
muikeasti	['PCLE_NOPEASTI']	clit=opt
mukaan	['PCLE_LIKI']	poss=opt
mukaan	['PCLE_VALTAAN']	poss=opt
mukaansatempaavasti	['PCLE_NOPEASTI']	clit=opt
mukaisesti	['PCLE_NOPEASTI']	clit=opt
mukana	['PCLE_KOTONA']	poss=opt
mukavasti	['PCLE_NOPEASTI']	clit=opt
mukiinmenevästi	['PCLE_TYHMÄSTI']	clit=opt
mullistavasti	['PCLE_NOPEASTI']	clit=opt
muodikkaasti	['PCLE_NOPEASTI']	clit=opt
muodinmukaisesti	['PCLE_NOPEASTI']	clit=opt
muodollisesti	['PCLE_NOPEASTI']	clit=opt
muodossa	['PCLE_KOTONA']	clit=opt
murhaavasti	['PCLE_NOPEASTI']	clit=opt
murheellisesti	['PCLE_NOPEASTI']	clit=opt
murskaavasti	['PCLE_NOPEASTI']	clit=opt
murteellisesti	['PCLE_NOPEASTI']	clit=opt
murteittain	['PCLE_VALTAAN']	clit=opt
musiikillisesti	['PCLE_NOPEASTI']	clit=opt
musikaalisesti	['PCLE_NOPEASTI']	clit=opt
mustasukkaisesti	['PCLE_NOPEASTI']	clit=opt
mutkattomasti	['PCLE_NOPEASTI']	clit=opt
mutkikkaasti	['PCLE_NOPEASTI']	clit=opt
mutrulla	['PCLE_KOTONA']	poss=opt
mutrulle	['PCLE_ALLE']	poss=opt
mutta	['PCLE_KOTONA']	clit=opt
muukalaisittain	['PCLE_VALTAAN']	clit=opt
muuten	['PCLE_VALTAAN']	clit=opt
muutoin	['PCLE_VALTAAN']	clit=opt
myrkyllisesti	['PCLE_TYHMÄSTI']	clit=opt
myrskyisästi	['PCLE_TYHMÄSTI']	clit=opt
mystisesti	['PCLE_TYHMÄSTI']	clit=opt
myönteisesti	['PCLE_TYHMÄSTI']	clit=opt
myöntyvästi	['PCLE_TYHMÄSTI']	clit=opt
myöntävästi	['PCLE_TYHMÄSTI']	clit=opt
myöten	['PCLE_NÄKYVIIN']	clit=opt
myötäisesti	['PCLE_TYHMÄSTI']	clit=opt
myötämielisesti	['PCLE_TYHMÄSTI']	clit=opt
myötä	['PCLE_IKINÄ']	poss=opt
myötätuntoisesti	['PCLE_NOPEASTI']	clit=opt
määräilevästi	['PCLE_TYHMÄSTI']	clit=opt
määräisesti	['PCLE_TYHMÄSTI']	clit=opt
määrällisesti	['PCLE_TYHMÄSTI']	clit=opt
määrätietoisesti	['PCLE_NOPEASTI']	clit=opt
määrättömästi	['PCLE_TYHMÄSTI']	clit=opt
määräävästi	['PCLE_TYHMÄSTI']	clit=opt
naftisti	['PCLE_NOPEASTI']	clit=opt
naiivisti	['PCLE_NOPEASTI']	clit=opt
naisellisesti	['PCLE_NOPEASTI']	clit=opt
naismaisesti	['PCLE_NOPEASTI']	clit=opt
napakasti	['PCLE_NOPEASTI']	clit=opt
narrimaisesti	['PCLE_NOPEASTI']	clit=opt
narsistisesti	['PCLE_NOPEASTI']	clit=opt
nasevasti	['PCLE_NOPEASTI']	clit=opt
naurettavasti	['PCLE_NOPEASTI']	clit=opt
nautinnollisesti	['PCLE_NOPEASTI']	clit=opt
nautittavasti	['PCLE_NOPEASTI']	clit=opt
navakasti	['PCLE_NOPEASTI']	clit=opt
negatiivisesti	['PCLE_NOPEASTI']	clit=opt
neitseellisesti	['PCLE_TYHMÄSTI']	clit=opt
nelikätisesti	['PCLE_TYHMÄSTI']	clit=opt
nelinkertaisesti	['PCLE_NOPEASTI']	clit=opt
nelittäin	['PCLE_NÄKYVIIN']	clit=opt
neliäänisesti	['PCLE_TYHMÄSTI']	clit=opt
neliöittäin	['PCLE_NÄKYVIIN']	clit=opt
neliömetreittäin	['PCLE_NÄKYVIIN']	clit=opt
neljännesvuosittain	['PCLE_VALTAAN']	clit=opt
neljästi	['PCLE_TYHMÄSTI']	clit=opt
nenäkkäästi	['PCLE_TYHMÄSTI']	clit=opt
nerokkaasti	['PCLE_NOPEASTI']	clit=opt
neutraalisti	['PCLE_NOPEASTI']	clit=opt
neuvokkaasti	['PCLE_NOPEASTI']	clit=opt
nidoksittain	['PCLE_VALTAAN']	clit=opt
nihkeästi	['PCLE_TYHMÄSTI']	clit=opt
niinikään	['PCLE_NÄKYVIIN']	clit=opt
niin sanotusti	['PCLE_NOPEASTI']	clit=opt
nimellisesti	['PCLE_TYHMÄSTI']	clit=opt
nimenomaisesti	['PCLE_NOPEASTI']	clit=opt
nimissä	['PCLE_IKINÄ']	poss=opt
nimittäin	['PCLE_NÄKYVIIN']	clit=opt
nipinnapin	['PCLE_VALTAAN']	clit=opt
nipuittain	['PCLE_VALTAAN']	clit=opt
nirpalla	['PCLE_KOTONA']	poss=opt
nirsosti	['PCLE_NOPEASTI']	clit=opt
niskalla	['PCLE_KOTONA']	poss=opt
niskalle	['PCLE_ALLE']	poss=opt
niskalta	['PCLE_KOTONA']	poss=opt
niukasti	['PCLE_NOPEASTI']	clit=opt
niukkasanaisesti	['PCLE_NOPEASTI']	clit=opt
nojalla	['PCLE_KOTONA']	poss=opt
nokittain	['PCLE_VALTAAN']	clit=opt
nokkavasti	['PCLE_NOPEASTI']	clit=opt
nokkelasti	['PCLE_NOPEASTI']	clit=opt
nolosti	['PCLE_NOPEASTI']	clit=opt
nopeasti	['PCLE_NOPEASTI']	clit=opt
nopsasti	['PCLE_NOPEASTI']	clit=opt
normaalisti	['PCLE_NOPEASTI']	clit=opt
nostalgisesti	['PCLE_NOPEASTI']	clit=opt
notkeasti	['PCLE_NOPEASTI']	clit=opt
nousukasmaisesti	['PCLE_NOPEASTI']	clit=opt
nuhteettomasti	['PCLE_NOPEASTI']	clit=opt
nuivasti	['PCLE_NOPEASTI']	clit=opt
nukuksiin	['PCLE_VALTAAN']	poss=opt
nukuksissa	['PCLE_KOTONA']	poss=opt
numerollisesti	['PCLE_NOPEASTI']	clit=opt
nuorekkaasti	['PCLE_NOPEASTI']	clit=opt
nurinkurisesti	['PCLE_NOPEASTI']	clit=opt
nurjamielisesti	['PCLE_TYHMÄSTI']	clit=opt
nurjasti	['PCLE_NOPEASTI']	clit=opt
nurkittain	['PCLE_VALTAAN']	clit=opt
nuukasti	['PCLE_NOPEASTI']	clit=opt
nykyaikaisesti	['PCLE_NOPEASTI']	clit=opt
nykäyksittäin	['PCLE_NÄKYVIIN']	clit=opt
nyreästi	['PCLE_TYHMÄSTI']	clit=opt
nyrpeästi	['PCLE_TYHMÄSTI']	clit=opt
näennäisesti	['PCLE_TYHMÄSTI']	clit=opt
nähden	['PCLE_NÄKYVIIN']	clit=opt
nähtävästi	['PCLE_TYHMÄSTI']	clit=opt
näinollen	['PCLE_VALTAAN']	clit=opt
näkymättömästi	['PCLE_TYHMÄSTI']	clit=opt
näkyviin	['PCLE_NÄKYVIIN']	poss=opt
näkyville	['PCLE_YLLE']	poss=opt
näkyvillä	['PCLE_IKINÄ']	poss=opt
näkyviltä	['PCLE_IKINÄ']	poss=opt
näkyvissä	['PCLE_IKINÄ']	poss=opt
näkyvistä	['PCLE_IKINÄ']	poss=opt
näkyvästi	['PCLE_TYHMÄSTI']	clit=opt
näkökulmasta	['PCLE_KOTONA']	poss=opt
näppärästi	['PCLE_TYHMÄSTI']	clit=opt
näpsäkästi	['PCLE_TYHMÄSTI']	clit=opt
näpsästi	['PCLE_TYHMÄSTI']	clit=opt
näpäkästi	['PCLE_TYHMÄSTI']	clit=opt
nätisti	['PCLE_TYHMÄSTI']	clit=opt
nöyrästi	['PCLE_TYHMÄSTI']	clit=opt
objektiivisesti	['PCLE_NOPEASTI']	clit=opt
odotetusti	['PCLE_NOPEASTI']	clit=opt
odottamattomasti	['PCLE_NOPEASTI']	clit=opt
odotuksenmukaisesti	['PCLE_NOPEASTI']	clit=opt
odotuksenvastaisesti	['PCLE_NOPEASTI']	clit=opt
ohella	['PCLE_KOTONA']	poss=opt
ohimenevästi	['PCLE_TYHMÄSTI']	clit=opt
ohitse	['PCLE_ALLE']	poss=opt
ohjelmallisesti	['PCLE_NOPEASTI']	clit=opt
ohraisesti	['PCLE_NOPEASTI']	clit=opt
ohuesti	['PCLE_NOPEASTI']	clit=opt
oikea-aikaisesti	['PCLE_NOPEASTI']	clit=opt
oikeamielisesti	['PCLE_TYHMÄSTI']	clit=opt
oikeaoppisesti	['PCLE_NOPEASTI']	clit=opt
oikeasti	['PCLE_NOPEASTI']	clit=opt
oikeestaan	['PCLE_VALTAAN']	clit=opt
oikein	['PCLE_VALTAAN']	clit=opt
oikeudellisesti	['PCLE_NOPEASTI']	clit=opt
oikeudenmukaisesti	['PCLE_NOPEASTI']	clit=opt
oikeudenvastaisesti	['PCLE_NOPEASTI']	clit=opt
oikeudettomasti	['PCLE_NOPEASTI']	clit=opt
oikeutetusti	['PCLE_NOPEASTI']	clit=opt
oikukkaasti	['PCLE_NOPEASTI']	clit=opt
oikullisesti	['PCLE_NOPEASTI']	clit=opt
oivallisesti	['PCLE_NOPEASTI']	clit=opt
ojolla	['PCLE_KOTONA']	poss=opt
ojolle	['PCLE_ALLE']	poss=opt
olennaisesti	['PCLE_NOPEASTI']	clit=opt
oletettavasti	['PCLE_NOPEASTI']	clit=opt
oma-aloitteisesti	['PCLE_NOPEASTI']	clit=opt
omaehtoisesti	['PCLE_NOPEASTI']	clit=opt
omahyväisesti	['PCLE_TYHMÄSTI']	clit=opt
-omaisesti	['PCLE_NOPEASTI']	clit=opt
omakohtaisesti	['PCLE_NOPEASTI']	clit=opt
omakätisesti	['PCLE_TYHMÄSTI']	clit=opt
omalaatuisesti	['PCLE_NOPEASTI']	clit=opt
omaperäisesti	['PCLE_TYHMÄSTI']	clit=opt
omapäisesti	['PCLE_TYHMÄSTI']	clit=opt
omatoimisesti	['PCLE_NOPEASTI']	clit=opt
omavaltaisesti	['PCLE_NOPEASTI']	clit=opt
omavastuisesti	['PCLE_NOPEASTI']	clit=opt
ominaisesti	['PCLE_NOPEASTI']	clit=opt
omintakeisesti	['PCLE_NOPEASTI']	clit=opt
omistushaluisesti	['PCLE_NOPEASTI']	clit=opt
omituisesti	['PCLE_NOPEASTI']	clit=opt
ongelmallisesti	['PCLE_NOPEASTI']	clit=opt
onnekkaasti	['PCLE_NOPEASTI']	clit=opt
onnellisesti	['PCLE_NOPEASTI']	clit=opt
onnettomasti	['PCLE_NOPEASTI']	clit=opt
onnistuneesti	['PCLE_NOPEASTI']	clit=opt
ontosti	['PCLE_NOPEASTI']	clit=opt
operatiivisesti	['PCLE_NOPEASTI']	clit=opt
opettavaisesti	['PCLE_NOPEASTI']	clit=opt
opettavasti	['PCLE_NOPEASTI']	clit=opt
opillisesti	['PCLE_NOPEASTI']	clit=opt
oppineesti	['PCLE_NOPEASTI']	clit=opt
optimistisesti	['PCLE_NOPEASTI']	clit=opt
optisesti	['PCLE_NOPEASTI']	clit=opt
oraakkelimaisesti	['PCLE_NOPEASTI']	clit=opt
orgaanisesti	['PCLE_NOPEASTI']	clit=opt
orjallisesti	['PCLE_NOPEASTI']	clit=opt
orjamaisesti	['PCLE_NOPEASTI']	clit=opt
osaaottavasti	['PCLE_NOPEASTI']	clit=opt
osalta	['PCLE_KOTONA']	poss=opt
osapäivätoimisesti	['PCLE_NOPEASTI']	clit=opt
osittain	['PCLE_VALTAAN']	clit=opt
osuvasti	['PCLE_NOPEASTI']	clit=opt
otaksuttavasti	['PCLE_NOPEASTI']	clit=opt
otollisesti	['PCLE_NOPEASTI']	clit=opt
oudosti	['PCLE_NOPEASTI']	clit=opt
ovelasti	['PCLE_NOPEASTI']	clit=opt
paatoksellisesti	['PCLE_NOPEASTI']	clit=opt
P	['ACRO_EE']	clit=opt
P	['ACRO_EE']	clit=opt
P	['ACRO_EE']	clit=opt
P	['ACRO_EE']	clit=opt
P	['ACRO_EE']	clit=opt
P	['ACRO_EE']	clit=opt
P	['ACRO_EE']	clit=opt
P	['ACRO_EE']	clit=opt
P	['ACRO_EE']	clit=opt
P	['ACRO_EE']	clit=opt
P	['ACRO_EE']	clit=opt
P	['ACRO_EE']	clit=opt
P	['ACRO_EE']	clit=opt
P	['ACRO_EE']	clit=opt
P	['ACRO_EE']	clit=opt
P	['ACRO_EE']	clit=opt
P	['ACRO_EE']	clit=opt
P	['ACRO_EE']	clit=opt
P	['ACRO_EE']	clit=opt
P	['ACRO_EE']	clit=opt
P	['ACRO_EE']	clit=opt
P	['ACRO_EE']	clit=opt
P	['ACRO_EE']	clit=opt
P	['ACRO_EE']	clit=opt
P	['ACRO_EE']	clit=opt
P	['ACRO_EE']	clit=opt
P	['ACRO_EE']	clit=opt
P	['ACRO_EE']	clit=opt
P	['ACRO_EE']	clit=opt
P	['ACRO_EE']	clit=opt
P	['ACRO_EE']	clit=opt
P	['ACRO_EE']	clit=opt
P	['ACRO_EE']	clit=opt
P	['ACRO_EE']	clit=opt
P	['ACRO_EE']	clit=opt
P	['ACRO_EE']	clit=opt
P	['ACRO_EE']	clit=opt
P	['ACRO_EE']	clit=opt
P	['ACRO_EE']	clit=opt
P	['ACRO_EE']	clit=opt
P	['ACRO_EE']	clit=opt
P	['ACRO_EE']	clit=opt
P	['ACRO_EE']	clit=opt
P	['ACRO_EE']	clit=opt
P	['ACRO_EE']	clit=opt
P	['ACRO_EE']	clit=opt
P	['ACRO_EE']	clit=opt
P	['ACRO_EE']	clit=opt
P	['ACRO_EE']	clit=opt
P	['ACRO_EE']	clit=opt
P	['ACRO_EE']	clit=opt
P	['ACRO_EE']	clit=opt
P	['ACRO_EE']	clit=opt
P	['ACRO_EE']	clit=opt
P	['ACRO_EE']	clit=opt
P	['ACRO_EE']	clit=opt
P	['ACRO_EE']	clit=opt
P	['ACRO_EE']	clit=opt
P	['ACRO_EE']	clit=opt
P	['ACRO_EE']	clit=opt
P	['ACRO_EE']	poss=opt
P	['ACRO_EE']	clit=opt
P	['ACRO_EE']	clit=opt
P	['ACRO_EE']	clit=opt
P	['ACRO_EE']	clit=opt
P	['ACRO_EE']	poss=opt
P	['ACRO_EE']	poss=opt
P	['ACRO_EE']	clit=opt
P	['ACRO_EE']	clit=opt
P	['ACRO_EE']	poss=opt
P	['ACRO_EE']	clit=opt
P	['ACRO_EE']	clit=opt
P	['ACRO_EE']	clit=opt
P	['ACRO_EE']	clit=opt
P	['ACRO_EE']	clit=opt
P	['ACRO_EE']	clit=opt
P	['ACRO_EE']	clit=opt
P	['ACRO_EE']	clit=opt
P	['ACRO_EE']	poss=opt
P	['ACRO_EE']	poss=opt
P	['ACRO_EE']	clit=opt
P	['ACRO_EE']	clit=opt
P	['ACRO_EE']	clit=opt
P	['ACRO_EE']	clit=opt
P	['ACRO_EE']	clit=opt
P	['ACRO_EE']	clit=opt
P	['ACRO_EE']	clit=opt
P	['ACRO_EE']	clit=opt
P	['ACRO_EE']	clit=opt
P	['ACRO_EE']	clit=opt
P	['ACRO_EE']	clit=opt
P	['ACRO_EE']	clit=opt
P	['ACRO_EE']	clit=opt
P	['ACRO_EE']	clit=opt
P	['ACRO_EE']	clit=opt
P	['ACRO_EE']	clit=opt
P	['ACRO_EE']	clit=opt
P	['ACRO_EE']	clit=opt
P	['ACRO_EE']	clit=opt
P	['ACRO_EE']	clit=opt
P	['ACRO_EE']	clit=opt
P	['ACRO_EE']	clit=opt
P	['ACRO_EE']	clit=opt
P	['ACRO_EE']	clit=opt
P	['ACRO_EE']	clit=opt
P	['ACRO_EE']	clit=opt
P	['ACRO_EE']	clit=opt
P	['ACRO_EE']	clit=opt
P	['ACRO_EE']	clit=opt
P	['ACRO_EE']	clit=opt
P	['ACRO_EE']	clit=opt
P	['ACRO_EE']	clit=opt
P	['ACRO_EE']	clit=opt
P	['ACRO_EE']	clit=opt
P	['ACRO_EE']	clit=opt
P	['ACRO_EE']	clit=opt
P	['ACRO_EE']	clit=opt
P	['ACRO_EE']	clit=opt
P	['ACRO_EE']	clit=opt
P	['ACRO_EE']	clit=opt
P	['ACRO_EE']	clit=opt
P	['ACRO_EE']	clit=opt
P	['ACRO_EE']	clit=opt
P	['ACRO_EE']	clit=opt
P	['ACRO_EE']	clit=opt
P	['ACRO_EE']	clit=opt
P	['ACRO_EE']	clit=opt
P	['ACRO_EE']	clit=opt
P	['ACRO_EE']	clit=opt
P	['ACRO_EE']	clit=opt
P	['ACRO_EE']	clit=opt
P	['ACRO_EE']	clit=opt
P	['ACRO_EE']	clit=opt
P	['ACRO_EE']	clit=opt
P	['ACRO_EE']	clit=opt
P	['ACRO_EE']	clit=opt
P	['ACRO_EE']	clit=opt
P	['ACRO_EE']	clit=opt
P	['ACRO_EE']	clit=opt
P	['ACRO_EE']	clit=opt
P	['ACRO_EE']	clit=opt
P	['ACRO_EE']	clit=opt
P	['ACRO_EE']	clit=opt
P	['ACRO_EE']	clit=opt
P	['ACRO_EE']	clit=opt
P	['ACRO_EE']	clit=opt
P	['ACRO_EE']	clit=opt
P	['ACRO_EE']	clit=opt
P	['ACRO_EE']	clit=opt
P	['ACRO_EE']	clit=opt
P	['ACRO_EE']	clit=opt
P	['ACRO_EE']	clit=opt
P	['ACRO_EE']	clit=opt
P	['ACRO_EE']	clit=opt
P	['ACRO_EE']	clit=opt
P	['ACRO_EE']	clit=opt
P	['ACRO_EE']	clit=opt
P	['ACRO_EE']	clit=opt
P	['ACRO_EE']	clit=opt
P	['ACRO_EE']	clit=opt
P	['ACRO_EE']	clit=opt
P	['ACRO_EE']	clit=opt
P	['ACRO_EE']	clit=opt
P	['ACRO_EE']	clit=opt
P	['ACRO_EE']	clit=opt
P	['ACRO_EE']	clit=opt
P	['ACRO_EE']	clit=opt
P	['ACRO_EE']	clit=opt
P	['ACRO_EE']	clit=opt
P	['ACRO_EE']	clit=opt
P	['ACRO_EE']	clit=opt
P	['ACRO_EE']	clit=opt
P	['ACRO_EE']	clit=opt
P	['ACRO_EE']	clit=opt
P	['ACRO_EE']	clit=opt
P	['ACRO_EE']	clit=opt
P	['ACRO_EE']	clit=opt
P	['ACRO_EE']	clit=opt
P	['ACRO_EE']	clit=opt
P	['ACRO_EE']	clit=opt
P	['ACRO_EE']	clit=opt
P	['ACRO_EE']	clit=opt
P	['ACRO_EE']	clit=opt
P	['ACRO_EE']	clit=opt
P	['ACRO_EE']	clit=opt
P	['ACRO_EE']	clit=opt
P	['ACRO_EE']	clit=opt
P	['ACRO_EE']	clit=opt
P	['ACRO_EE']	clit=opt
P	['ACRO_EE']	clit=opt
P	['ACRO_EE']	clit=opt
P	['ACRO_EE']	clit=opt
P	['ACRO_EE']	clit=opt
P	['ACRO_EE']	clit=opt
P	['ACRO_EE']	clit=opt
P	['ACRO_EE']	clit=opt
P	['ACRO_EE']	clit=opt
P	['ACRO_EE']	clit=opt
P	['ACRO_EE']	clit=opt
P	['ACRO_EE']	clit=opt
P	['ACRO_EE']	clit=opt
P	['ACRO_EE']	clit=opt
P	['ACRO_EE']	clit=opt
P	['ACRO_EE']	clit=opt
P	['ACRO_EE']	clit=opt
P	['ACRO_EE']	clit=opt
P	['ACRO_EE']	clit=opt
P	['ACRO_EE']	clit=opt
P	['ACRO_EE']	clit=opt
P	['ACRO_EE']	clit=opt
P	['ACRO_EE']	clit=opt
P	['ACRO_EE']	poss=opt
P	['ACRO_EE']	poss=opt
P	['ACRO_EE']	poss=opt
P	['ACRO_EE']	poss=opt
P	['ACRO_EE']	poss=opt
P	['ACRO_EE']	clit=opt
P	['ACRO_EE']	clit=opt
P	['ACRO_EE']	poss=opt
P	['ACRO_EE']	clit=opt
P	['ACRO_EE']	clit=opt
P	['ACRO_EE']	clit=opt
P	['ACRO_EE']	clit=opt
P	['ACRO_EE']	clit=opt
P	['ACRO_EE']	clit=opt
P	['ACRO_EE']	clit=opt
P	['ACRO_EE']	clit=opt
P	['ACRO_EE']	clit=opt
P	['ACRO_EE']	clit=opt
P	['ACRO_EE']	clit=opt
P	['ACRO_EE']	clit=opt
P	['ACRO_EE']	clit=opt
P	['ACRO_EE']	clit=opt
P	['ACRO_EE']	clit=opt
P	['ACRO_EE']	clit=opt
P	['ACRO_EE']	clit=opt
P	['ACRO_EE']	clit=opt
P	['ACRO_EE']	clit=opt
P	['ACRO_EE']	clit=opt
P	['ACRO_EE']	clit=opt
P	['ACRO_EE']	clit=opt
P	['ACRO_EE']	clit=opt
P	['ACRO_EE']	poss=opt
P	['ACRO_EE']	clit=opt
P	['ACRO_EE']	clit=opt
P	['ACRO_EE']	clit=opt
P	['ACRO_EE']	clit=opt
P	['ACRO_EE']	clit=opt
P	['ACRO_EE']	clit=opt
P	['ACRO_EE']	clit=opt
P	['ACRO_EE']	clit=opt
P	['ACRO_EE']	clit=opt
P	['ACRO_EE']	clit=opt
P	['ACRO_EE']	clit=opt
P	['ACRO_EE']	clit=opt
P	['ACRO_EE']	clit=opt
P	['ACRO_EE']	clit=opt
P	['ACRO_EE']	clit=opt
P	['ACRO_EE']	clit=opt
P	['ACRO_EE']	clit=opt
P	['ACRO_EE']	clit=opt
P	['ACRO_EE']	clit=opt
P	['ACRO_EE']	clit=opt
P	['ACRO_EE']	clit=opt
P	['ACRO_EE']	clit=opt
P	['ACRO_EE']	clit=opt
P	['ACRO_EE']	clit=opt
P	['ACRO_EE']	clit=opt
P	['ACRO_EE']	clit=opt
P	['ACRO_EE']	clit=opt
P	['ACRO_EE']	clit=opt
P	['ACRO_EE']	clit=opt
P	['ACRO_EE']	clit=opt
P	['ACRO_EE']	clit=opt
P	['ACRO_EE']	clit=opt
P	['ACRO_EE']	clit=opt
P	['ACRO_EE']	clit=opt
P	['ACRO_EE']	clit=opt
P	['ACRO_EE']	clit=opt
P	['ACRO_EE']	clit=opt
P	['ACRO_EE']	clit=opt
P	['ACRO_EE']	clit=opt
P	['ACRO_EE']	clit=opt
P	['ACRO_EE']	clit=opt
P	['ACRO_EE']	clit=opt
P	['ACRO_EE']	clit=opt
P	['ACRO_EE']	clit=opt
P	['ACRO_EE']	clit=opt
P	['ACRO_EE']	clit=opt
P	['ACRO_EE']	clit=opt
P	['ACRO_EE']	clit=opt
P	['ACRO_EE']	clit=opt
P	['ACRO_EE']	clit=opt
P	['ACRO_EE']	clit=opt
P	['ACRO_EE']	clit=opt
P	['ACRO_EE']	clit=opt
P	['ACRO_EE']	clit=opt
P	['ACRO_EE']	clit=opt
P	['ACRO_EE']	clit=opt
P	['ACRO_EE']	clit=opt
P	['ACRO_EE']	clit=opt
P	['ACRO_EE']	clit=opt
P	['ACRO_EE']	clit=opt
P	['ACRO_EE']	clit=opt
P	['ACRO_EE']	clit=opt
P	['ACRO_EE']	clit=opt
P	['ACRO_EE']	clit=opt
P	['ACRO_EE']	clit=opt
P	['ACRO_EE']	clit=opt
P	['ACRO_EE']	clit=opt
P	['ACRO_EE']	clit=opt
P	['ACRO_EE']	clit=opt
P	['ACRO_EE']	clit=opt
P	['ACRO_EE']	clit=opt
P	['ACRO_EE']	clit=opt
P	['ACRO_EE']	clit=opt
P	['ACRO_EE']	clit=opt
P	['ACRO_EE']	clit=opt
P	['ACRO_EE']	clit=opt
P	['ACRO_EE']	clit=opt
P	['ACRO_EE']	clit=opt
P	['ACRO_EE']	clit=opt
P	['ACRO_EE']	clit=opt
P	['ACRO_EE']	clit=opt
P	['ACRO_EE']	clit=opt
P	['ACRO_EE']	clit=opt
P	['ACRO_EE']	clit=opt
P	['ACRO_EE']	clit=opt
P	['ACRO_EE']	clit=opt
P	['ACRO_EE']	clit=opt
P	['ACRO_EE']	clit=opt
P	['ACRO_EE']	clit=opt
P	['ACRO_EE']	clit=opt
P	['ACRO_EE']	clit=opt
P	['ACRO_EE']	clit=opt
P	['ACRO_EE']	clit=opt
P	['ACRO_EE']	clit=opt
P	['ACRO_EE']	clit=opt
P	['ACRO_EE']	clit=opt
P	['ACRO_EE']	clit=opt
P	['ACRO_EE']	clit=opt
P	['ACRO_EE']	clit=opt
P	['ACRO_EE']	clit=opt
P	['ACRO_EE']	clit=opt
P	['ACRO_EE']	clit=opt
P	['ACRO_EE']	clit=opt
P	['ACRO_EE']	clit=opt
P	['ACRO_EE']	clit=opt
P	['ACRO_EE']	clit=opt
P	['ACRO_EE']	clit=opt
P	['ACRO_EE']	clit=opt
P	['ACRO_EE']	clit=opt
P	['ACRO_EE']	clit=opt
P	['ACRO_EE']	clit=opt
P	['ACRO_EE']	clit=opt
P	['ACRO_EE']	clit=opt
P	['ACRO_EE']	clit=opt
P	['ACRO_EE']	clit=opt
P	['ACRO_EE']	clit=opt
P	['ACRO_EE']	clit=opt
P	['ACRO_EE']	clit=opt
P	['ACRO_EE']	clit=opt
P	['ACRO_EE']	clit=opt
P	['ACRO_EE']	clit=opt
P	['ACRO_EE']	clit=opt
P	['ACRO_EE']	clit=opt
P	['ACRO_EE']	clit=opt
P	['ACRO_EE']	clit=opt
P	['ACRO_EE']	clit=opt
P	['ACRO_EE']	clit=opt
P	['ACRO_EE']	clit=opt
P	['ACRO_EE']	clit=opt
P	['ACRO_EE']	clit=opt
P	['ACRO_EE']	clit=opt
P	['ACRO_EE']	clit=opt
P	['ACRO_EE']	clit=opt
P	['ACRO_EE']	clit=opt
P	['ACRO_EE']	clit=opt
P	['ACRO_EE']	clit=opt
P	['ACRO_EE']	clit=opt
P	['ACRO_EE']	clit=opt
P	['ACRO_EE']	clit=opt
P	['ACRO_EE']	clit=opt
P	['ACRO_EE']	clit=opt
P	['ACRO_EE']	clit=opt
P	['ACRO_EE']	clit=opt
P	['ACRO_EE']	clit=opt
P	['ACRO_EE']	clit=opt
P	['ACRO_EE']	clit=opt
P	['ACRO_EE']	clit=opt
P	['ACRO_EE']	clit=opt
P	['ACRO_EE']	clit=opt
P	['ACRO_EE']	clit=opt
P	['ACRO_EE']	clit=opt
P	['ACRO_EE']	clit=opt
P	['ACRO_EE']	clit=opt
P	['ACRO_EE']	clit=opt
P	['ACRO_EE']	clit=opt
P	['ACRO_EE']	clit=opt
P	['ACRO_EE']	poss=opt
P	['ACRO_EE']	clit=opt
P	['ACRO_EE']	clit=opt
P	['ACRO_EE']	clit=opt
P	['ACRO_EE']	clit=opt
P	['ACRO_EE']	clit=opt
P	['ACRO_EE']	clit=opt
P	['ACRO_EE']	clit=opt
P	['ACRO_EE']	clit=opt
P	['ACRO_EE']	clit=opt
P	['ACRO_EE']	clit=opt
P	['ACRO_EE']	clit=opt
P	['ACRO_EE']	clit=opt
P	['ACRO_EE']	clit=opt
P	['ACRO_EE']	clit=opt
P	['ACRO_EE']	clit=opt
P	['ACRO_EE']	clit=opt
P	['ACRO_EE']	clit=opt
P	['ACRO_EE']	clit=opt
P	['ACRO_EE']	clit=opt
P	['ACRO_EE']	clit=opt
P	['ACRO_EE']	clit=opt
P	['ACRO_EE']	clit=opt
P	['ACRO_EE']	clit=opt
P	['ACRO_EE']	clit=opt
P	['ACRO_EE']	clit=opt
P	['ACRO_EE']	clit=opt
P	['ACRO_EE']	clit=opt
P	['ACRO_EE']	clit=opt
P	['ACRO_EE']	clit=opt
P	['ACRO_EE']	clit=opt
P	['ACRO_EE']	clit=opt
P	['ACRO_EE']	clit=opt
P	['ACRO_EE']	clit=opt
P	['ACRO_EE']	clit=opt
P	['ACRO_EE']	clit=opt
P	['ACRO_EE']	clit=opt
P	['ACRO_EE']	clit=opt
P	['ACRO_EE']	clit=opt
P	['ACRO_EE']	clit=opt
P	['ACRO_EE']	clit=opt
P	['ACRO_EE']	clit=opt
P	['ACRO_EE']	clit=opt
P	['ACRO_EE']	clit=opt
P	['ACRO_EE']	clit=opt
P	['ACRO_EE']	clit=opt
P	['ACRO_EE']	clit=opt
P	['ACRO_EE']	clit=opt
P	['ACRO_EE']	clit=opt
P	['ACRO_EE']	clit=opt
P	['ACRO_EE']	clit=opt
P	['ACRO_EE']	clit=opt
P	['ACRO_EE']	clit=opt
P	['ACRO_EE']	clit=opt
P	['ACRO_EE']	clit=opt
P	['ACRO_EE']	clit=opt
P	['ACRO_EE']	clit=opt
P	['ACRO_EE']	clit=opt
P	['ACRO_EE']	clit=opt
P	['ACRO_EE']	clit=opt
P	['ACRO_EE']	clit=opt
P	['ACRO_EE']	clit=opt
P	['ACRO_EE']	clit=opt
P	['ACRO_EE']	clit=opt
P	['ACRO_EE']	clit=opt
P	['ACRO_EE']	clit=opt
P	['ACRO_EE']	clit=opt
P	['ACRO_EE']	clit=opt
P	['ACRO_EE']	clit=opt
P	['ACRO_EE']	clit=opt
P	['ACRO_EE']	clit=opt
P	['ACRO_EE']	clit=opt
P	['ACRO_EE']	clit=opt
P	['ACRO_EE']	clit=opt
P	['ACRO_EE']	clit=opt
P	['ACRO_EE']	clit=opt
P	['ACRO_EE']	clit=opt
P	['ACRO_EE']	poss=opt
P	['ACRO_EE']	poss=opt
P	['ACRO_EE']	clit=opt
P	['ACRO_EE']	clit=opt
P	['ACRO_EE']	clit=opt
P	['ACRO_EE']	clit=opt
P	['ACRO_EE']	clit=opt
P	['ACRO_EE']	clit=opt
P	['ACRO_EE']	poss=opt
P	['ACRO_EE']	poss=opt
P	['ACRO_EE']	clit=opt
P	['ACRO_EE']	poss=opt
P	['ACRO_EE']	clit=opt
P	['ACRO_EE']	clit=opt
P	['ACRO_EE']	clit=opt
P	['ACRO_EE']	clit=opt
P	['ACRO_EE']	poss=opt
P	['ACRO_EE']	poss=opt
P	['ACRO_EE']	clit=opt
P	['ACRO_EE']	clit=opt
P	['ACRO_EE']	clit=opt
P	['ACRO_EE']	clit=opt
P	['ACRO_EE']	poss=opt
P	['ACRO_EE']	poss=opt
P	['ACRO_EE']	poss=opt
P	['ACRO_EE']	poss=opt
P	['ACRO_EE']	clit=opt
P	['ACRO_EE']	clit=opt
P	['ACRO_EE']	clit=opt
P	['ACRO_EE']	clit=opt
P	['ACRO_EE']	clit=opt
P	['ACRO_EE']	clit=opt
P	['ACRO_EE']	clit=opt
P	['ACRO_EE']	clit=opt
P	['ACRO_EE']	clit=opt
P	['ACRO_EE']	clit=opt
P	['ACRO_EE']	clit=opt
P	['ACRO_EE']	clit=opt
P	['ACRO_EE']	clit=opt
P	['ACRO_EE']	clit=opt
P	['ACRO_EE']	clit=opt
P	['ACRO_EE']	clit=opt
P	['ACRO_EE']	clit=opt
P	['ACRO_EE']	clit=opt
P	['ACRO_EE']	clit=opt
P	['ACRO_EE']	clit=opt
P	['ACRO_EE']	clit=opt
P	['ACRO_EE']	clit=opt
P	['ACRO_EE']	clit=opt
P	['ACRO_EE']	clit=opt
P	['ACRO_EE']	clit=opt
P	['ACRO_EE']	clit=opt
P	['ACRO_EE']	clit=opt
P	['ACRO_EE']	clit=opt
P	['ACRO_EE']	clit=opt
P	['ACRO_EE']	clit=opt
P	['ACRO_EE']	clit=opt
P	['ACRO_EE']	clit=opt
P	['ACRO_EE']	clit=opt
P	['ACRO_EE']	poss=opt
P	['ACRO_EE']	clit=opt
P	['ACRO_EE']	poss=opt
P	['ACRO_EE']	poss=opt
P	['ACRO_EE']	clit=opt
P	['ACRO_EE']	clit=opt
P	['ACRO_EE']	clit=opt
P	['ACRO_EE']	clit=opt
P	['ACRO_EE']	clit=opt
P	['ACRO_EE']	clit=opt
P	['ACRO_EE']	clit=opt
P	['ACRO_EE']	clit=opt
P	['ACRO_EE']	clit=opt
P	['ACRO_EE']	clit=opt
P	['ACRO_EE']	clit=opt
P	['ACRO_EE']	clit=opt
P	['ACRO_EE']	clit=opt
P	['ACRO_EE']	clit=opt
P	['ACRO_EE']	clit=opt
P	['ACRO_EE']	clit=opt
P	['ACRO_EE']	clit=opt
P	['ACRO_EE']	clit=opt
P	['ACRO_EE']	clit=opt
P	['ACRO_EE']	clit=opt
P	['ACRO_EE']	clit=opt
P	['ACRO_EE']	clit=opt
P	['ACRO_EE']	clit=opt
P	['ACRO_EE']	clit=opt
P	['ACRO_EE']	clit=opt
P	['ACRO_EE']	clit=opt
P	['ACRO_EE']	clit=opt
P	['ACRO_EE']	clit=opt
P	['ACRO_EE']	clit=opt
P	['ACRO_EE']	clit=opt
P	['ACRO_EE']	clit=opt
P	['ACRO_EE']	clit=opt
P	['ACRO_EE']	clit=opt
P	['ACRO_EE']	clit=opt
P	['ACRO_EE']	clit=opt
P	['ACRO_EE']	clit=opt
P	['ACRO_EE']	clit=opt
P	['ACRO_EE']	clit=opt
P	['ACRO_EE']	clit=opt
P	['ACRO_EE']	clit=opt
P	['ACRO_EE']	clit=opt
P	['ACRO_EE']	clit=opt
P	['ACRO_EE']	clit=opt
P	['ACRO_EE']	clit=opt
P	['ACRO_EE']	clit=opt
P	['ACRO_EE']	clit=opt
P	['ACRO_EE']	clit=opt
P	['ACRO_EE']	clit=opt
P	['ACRO_EE']	clit=opt
P	['ACRO_EE']	clit=opt
P	['ACRO_EE']	poss=opt
P	['ACRO_EE']	clit=opt
P	['ACRO_EE']	clit=opt
P	['ACRO_EE']	poss=opt
P	['ACRO_EE']	clit=opt
P	['ACRO_EE']	clit=opt
P	['ACRO_EE']	clit=opt
P	['ACRO_EE']	clit=opt
P	['ACRO_EE']	clit=opt
P	['ACRO_EE']	clit=opt
P	['ACRO_EE']	clit=opt
P	['ACRO_EE']	clit=opt
P	['ACRO_EE']	clit=opt
P	['ACRO_EE']	clit=opt
P	['ACRO_EE']	clit=opt
P	['ACRO_EE']	clit=opt
P	['ACRO_EE']	clit=opt
P	['ACRO_EE']	clit=opt
P	['ACRO_EE']	clit=opt
P	['ACRO_EE']	clit=opt
P	['ACRO_EE']	clit=opt
P	['ACRO_EE']	clit=opt
P	['ACRO_EE']	clit=opt
P	['ACRO_EE']	clit=opt
P	['ACRO_EE']	clit=opt
P	['ACRO_EE']	clit=opt
P	['ACRO_EE']	clit=opt
P	['ACRO_EE']	clit=opt
P	['ACRO_EE']	clit=opt
P	['ACRO_EE']	poss=opt
P	['ACRO_EE']	poss=opt
P	['ACRO_EE']	clit=opt
P	['ACRO_EE']	poss=opt
P	['ACRO_EE']	poss=opt
P	['ACRO_EE']	clit=opt
P	['ACRO_EE']	clit=opt
P	['ACRO_EE']	poss=opt
P	['ACRO_EE']	poss=opt
P	['ACRO_EE']	clit=opt
P	['ACRO_EE']	clit=opt
P	['ACRO_EE']	clit=opt
P	['ACRO_EE']	clit=opt
P	['ACRO_EE']	clit=opt
P	['ACRO_EE']	poss=obl
P	['ACRO_EE']	clit=opt
P	['ACRO_EE']	clit=opt
P	['ACRO_EE']	clit=opt
P	['ACRO_EE']	clit=opt
P	['ACRO_EE']	clit=opt
P	['ACRO_EE']	clit=opt
P	['ACRO_EE']	clit=opt
P	['ACRO_EE']	poss=opt
P	['ACRO_EE']	poss=opt
P	['ACRO_EE']	clit=opt
P	['ACRO_EE']	clit=opt
P	['ACRO_EE']	clit=opt
P	['ACRO_EE']	clit=opt
P	['ACRO_EE']	clit=opt
P	['ACRO_EE']	clit=opt
P	['ACRO_EE']	clit=opt
P	['ACRO_EE']	clit=opt
P	['ACRO_EE']	clit=opt
P	['ACRO_EE']	clit=opt
P	['ACRO_EE']	clit=opt
P	['ACRO_EE']	clit=opt
P	['ACRO_EE']	clit=opt
P	['ACRO_EE']	clit=opt
P	['ACRO_EE']	clit=opt
P	['ACRO_EE']	clit=opt
P	['ACRO_EE']	clit=opt
P	['ACRO_EE']	poss=opt
P	['ACRO_EE']	clit=opt
P	['ACRO_EE']	poss=opt
P	['ACRO_EE']	clit=opt
P	['ACRO_EE']	clit=opt
P	['ACRO_EE']	clit=opt
P	['ACRO_EE']	clit=opt
P	['ACRO_EE']	clit=opt
P	['ACRO_EE']	clit=opt
P	['ACRO_EE']	clit=opt
P	['ACRO_EE']	clit=opt
P	['ACRO_EE']	clit=opt
P	['ACRO_EE']	clit=opt
P	['ACRO_EE']	clit=opt
P	['ACRO_EE']	clit=opt
P	['ACRO_EE']	clit=opt
P	['ACRO_EE']	clit=opt
P	['ACRO_EE']	clit=opt
P	['ACRO_EE']	clit=opt
P	['ACRO_EE']	clit=opt
P	['ACRO_EE']	clit=opt
P	['ACRO_EE']	clit=opt
P	['ACRO_EE']	clit=opt
P	['ACRO_EE']	clit=opt
P	['ACRO_EE']	clit=opt
P	['ACRO_EE']	clit=opt
P	['ACRO_EE']	clit=opt
P	['ACRO_EE']	clit=opt
P	['ACRO_EE']	clit=opt
P	['ACRO_EE']	clit=opt
P	['ACRO_EE']	clit=opt
P	['ACRO_EE']	clit=opt
P	['ACRO_EE']	clit=opt
P	['ACRO_EE']	clit=opt
P	['ACRO_EE']	clit=opt
P	['ACRO_EE']	clit=opt
P	['ACRO_EE']	clit=opt
P	['ACRO_EE']	clit=opt
P	['ACRO_EE']	clit=opt
P	['ACRO_EE']	clit=opt
P	['ACRO_EE']	clit=opt
P	['ACRO_EE']	clit=opt
P	['ACRO_EE']	clit=opt
P	['ACRO_EE']	clit=opt
P	['ACRO_EE']	clit=opt
P	['ACRO_EE']	clit=opt
P	['ACRO_EE']	clit=opt
P	['ACRO_EE']	clit=opt
P	['ACRO_EE']	poss=opt
P	['ACRO_EE']	poss=opt
P	['ACRO_EE']	poss=opt
P	['ACRO_EE']	clit=opt
P	['ACRO_EE']	clit=opt
P	['ACRO_EE']	clit=opt
P	['ACRO_EE']	clit=opt
P	['ACRO_EE']	clit=opt
P	['ACRO_EE']	clit=opt
P	['ACRO_EE']	clit=opt
P	['ACRO_EE']	clit=opt
P	['ACRO_EE']	clit=opt
P	['ACRO_EE']	clit=opt
P	['ACRO_EE']	clit=opt
P	['ACRO_EE']	clit=opt
P	['ACRO_EE']	clit=opt
P	['ACRO_EE']	clit=opt
P	['ACRO_EE']	clit=opt
P	['ACRO_EE']	clit=opt
P	['ACRO_EE']	clit=opt
P	['ACRO_EE']	clit=opt
P	['ACRO_EE']	clit=opt
P	['ACRO_EE']	clit=opt
P	['ACRO_EE']	clit=opt
P	['ACRO_EE']	clit=opt
P	['ACRO_EE']	poss=opt
P	['ACRO_EE']	poss=opt
P	['ACRO_EE']	poss=opt
P	['ACRO_EE']	poss=opt
P	['ACRO_EE']	clit=opt
P	['ACRO_EE']	clit=opt
P	['ACRO_EE']	clit=opt
P	['ACRO_EE']	clit=opt
P	['ACRO_EE']	clit=opt
P	['ACRO_EE']	clit=opt
P	['ACRO_EE']	clit=opt
P	['ACRO_EE']	clit=opt
P	['ACRO_EE']	poss=obl
P	['ACRO_EE']	clit=opt
P	['ACRO_EE']	clit=opt
P	['ACRO_EE']	clit=opt
P	['ACRO_EE']	clit=opt
P	['ACRO_EE']	clit=opt
P	['ACRO_EE']	clit=opt
P	['ACRO_EE']	clit=opt
P	['ACRO_EE']	clit=opt
P	['ACRO_EE']	clit=opt
P	['ACRO_EE']	clit=opt
P	['ACRO_EE']	clit=opt
P	['ACRO_EE']	clit=opt
P	['ACRO_EE']	clit=opt
P	['ACRO_EE']	clit=opt
P	['ACRO_EE']	clit=opt
P	['ACRO_EE']	clit=opt
P	['ACRO_EE']	clit=opt
P	['ACRO_EE']	clit=opt
P	['ACRO_EE']	clit=opt
P	['ACRO_EE']	clit=opt
P	['ACRO_EE']	clit=opt
P	['ACRO_EE']	clit=opt
P	['ACRO_EE']	clit=opt
P	['ACRO_EE']	poss=opt
P	['ACRO_EE']	poss=opt
P	['ACRO_EE']	clit=opt
P	['ACRO_EE']	poss=opt
P	['ACRO_EE']	clit=opt
P	['ACRO_EE']	clit=opt
P	['ACRO_EE']	clit=opt
P	['ACRO_EE']	clit=opt
P	['ACRO_EE']	clit=opt
P	['ACRO_EE']	clit=opt
P	['ACRO_EE']	clit=opt
P	['ACRO_EE']	clit=opt
P	['ACRO_EE']	clit=opt
P	['ACRO_EE']	clit=opt
P	['ACRO_EE']	clit=opt
P	['ACRO_EE']	clit=opt
P	['ACRO_EE']	clit=opt
P	['ACRO_EE']	clit=opt
P	['ACRO_EE']	clit=opt
P	['ACRO_EE']	clit=opt
P	['ACRO_EE']	clit=opt
P	['ACRO_EE']	clit=opt
P	['ACRO_EE']	clit=opt
P	['ACRO_EE']	clit=opt
P	['ACRO_EE']	clit=opt
P	['ACRO_EE']	clit=opt
P	['ACRO_EE']	clit=opt
P	['ACRO_EE']	clit=opt
P	['ACRO_EE']	clit=opt
P	['ACRO_EE']	clit=opt
P	['ACRO_EE']	clit=opt
P	['ACRO_EE']	clit=opt
P	['ACRO_EE']	clit=opt
P	['ACRO_EE']	clit=opt
P	['ACRO_EE']	clit=opt
P	['ACRO_EE']	clit=opt
P	['ACRO_EE']	clit=opt
P	['ACRO_EE']	clit=opt
P	['ACRO_EE']	clit=opt
P	['ACRO_EE']	clit=opt
P	['ACRO_EE']	clit=opt
P	['ACRO_EE']	clit=opt
P	['ACRO_EE']	clit=opt
P	['ACRO_EE']	poss=opt
P	['ACRO_EE']	poss=opt
P	['ACRO_EE']	poss=opt
P	['ACRO_EE']	poss=opt
P	['ACRO_EE']	poss=opt
P	['ACRO_EE']	clit=opt
P	['ACRO_EE']	clit=opt
P	['ACRO_EE']	clit=opt
P	['ACRO_EE']	clit=opt
P	['ACRO_EE']	clit=opt
P	['ACRO_EE']	clit=opt
P	['ACRO_EE']	poss=opt
P	['ACRO_EE']	clit=opt
P	['ACRO_EE']	clit=opt
P	['ACRO_EE']	clit=opt
P	['ACRO_EE']	clit=opt
P	['ACRO_EE']	clit=opt
P	['ACRO_EE']	clit=opt
P	['ACRO_EE']	clit=opt
P	['ACRO_EE']	clit=opt
P	['ACRO_EE']	clit=opt
P	['ACRO_EE']	clit=opt
P	['ACRO_EE']	clit=opt
P	['ACRO_EE']	clit=opt
P	['ACRO_EE']	clit=opt
P	['ACRO_EE']	clit=opt
P	['ACRO_EE']	clit=opt
P	['ACRO_EE']	clit=opt
P	['ACRO_EE']	clit=opt
P	['ACRO_EE']	clit=opt
P	['ACRO_EE']	poss=obl
P	['ACRO_EE']	clit=opt
P	['ACRO_EE']	clit=opt
P	['ACRO_EE']	clit=opt
P	['ACRO_EE']	poss=opt
P	['ACRO_EE']	clit=opt
P	['ACRO_EE']	clit=opt
P	['ACRO_EE']	clit=opt
P	['ACRO_EE']	clit=opt
P	['ACRO_EE']	clit=opt
P	['ACRO_EE']	clit=opt
P	['ACRO_EE']	clit=opt
P	['ACRO_EE']	clit=opt
P	['ACRO_EE']	clit=opt
P	['ACRO_EE']	clit=opt
P	['ACRO_EE']	poss=opt
P	['ACRO_EE']	clit=opt
P	['ACRO_EE']	clit=opt
P	['ACRO_EE']	clit=opt
P	['ACRO_EE']	clit=opt
P	['ACRO_EE']	clit=opt
P	['ACRO_EE']	clit=opt
P	['ACRO_EE']	clit=opt
P	['ACRO_EE']	clit=opt
P	['ACRO_EE']	clit=opt
P	['ACRO_EE']	clit=opt
P	['ACRO_EE']	clit=opt
P	['ACRO_EE']	poss=opt
P	['ACRO_EE']	poss=opt
P	['ACRO_EE']	clit=opt
P	['ACRO_EE']	clit=opt
P	['ACRO_EE']	clit=opt
P	['ACRO_EE']	clit=opt
P	['ACRO_EE']	clit=opt
P	['ACRO_EE']	poss=opt
P	['ACRO_EE']	clit=opt
P	['ACRO_EE']	poss=opt
P	['ACRO_EE']	poss=opt
P	['ACRO_EE']	poss=opt
P	['ACRO_EE']	poss=opt
P	['ACRO_EE']	poss=opt
P	['ACRO_EE']	poss=opt
P	['ACRO_EE']	clit=opt
P	['ACRO_EE']	clit=opt
P	['ACRO_EE']	clit=opt
P	['ACRO_EE']	clit=opt
P	['ACRO_EE']	clit=opt
P	['ACRO_EE']	poss=opt
P	['ACRO_EE']	poss=opt
P	['ACRO_EE']	poss=opt
P	['ACRO_EE']	clit=opt
P	['ACRO_EE']	clit=opt
P	['ACRO_EE']	clit=opt
P	['ACRO_EE']	clit=opt
P	['ACRO_EE']	clit=opt
P	['ACRO_EE']	clit=opt
P	['ACRO_EE']	clit=opt
P	['ACRO_EE']	clit=opt
P	['ACRO_EE']	clit=opt
P	['ACRO_EE']	clit=opt
P	['ACRO_EE']	clit=opt
P	['ACRO_EE']	clit=opt
P	['ACRO_EE']	clit=opt
P	['ACRO_EE']	clit=opt
P	['ACRO_EE']	clit=opt
P	['ACRO_EE']	clit=opt
P	['ACRO_EE']	poss=opt
P	['ACRO_EE']	poss=opt
P	['ACRO_EE']	clit=opt
P	['ACRO_EE']	clit=opt
P	['ACRO_EE']	clit=opt
P	['ACRO_EE']	clit=opt
P	['ACRO_EE']	clit=opt
P	['ACRO_EE']	clit=opt
P	['ACRO_EE']	clit=opt
P	['ACRO_EE']	clit=opt
P	['ACRO_EE']	clit=opt
P	['ACRO_EE']	clit=opt
P	['ACRO_EE']	clit=opt
P	['ACRO_EE']	clit=opt
P	['ACRO_EE']	clit=opt
P	['ACRO_EE']	clit=opt
P	['ACRO_EE']	clit=opt
P	['ACRO_EE']	clit=opt
P	['ACRO_EE']	clit=opt
P	['ACRO_EE']	clit=opt
P	['ACRO_EE']	clit=opt
P	['ACRO_EE']	clit=opt
P	['ACRO_EE']	clit=opt
P	['ACRO_EE']	clit=opt
P	['ACRO_EE']	poss=opt
P	['ACRO_EE']	clit=opt
P	['ACRO_EE']	poss=opt
P	['ACRO_EE']	poss=opt
P	['ACRO_EE']	poss=opt
P	['ACRO_EE']	clit=opt
P	['ACRO_EE']	clit=opt
P	['ACRO_EE']	clit=opt
P	['ACRO_EE']	clit=opt
P	['ACRO_EE']	clit=opt
P	['ACRO_EE']	clit=opt
P	['ACRO_EE']	clit=opt
P	['ACRO_EE']	clit=opt
P	['ACRO_EE']	clit=opt
P	['ACRO_EE']	clit=opt
P	['ACRO_EE']	clit=opt
P	['ACRO_EE']	clit=opt
P	['ACRO_EE']	clit=opt
P	['ACRO_EE']	clit=opt
P	['ACRO_EE']	clit=opt
P	['ACRO_EE']	clit=opt
P	['ACRO_EE']	clit=opt
P	['ACRO_EE']	clit=opt
P	['ACRO_EE']	clit=opt
P	['ACRO_EE']	clit=opt
P	['ACRO_EE']	clit=opt
P	['ACRO_EE']	clit=opt
P	['ACRO_EE']	clit=opt
P	['ACRO_EE']	clit=opt
P	['ACRO_EE']	clit=opt
P	['ACRO_EE']	clit=opt
P	['ACRO_EE']	clit=opt
P	['ACRO_EE']	clit=opt
P	['ACRO_EE']	poss=opt
P	['ACRO_EE']	poss=opt
P	['ACRO_EE']	poss=opt
P	['ACRO_EE']	clit=opt
P	['ACRO_EE']	clit=opt
P	['ACRO_EE']	clit=opt
P	['ACRO_EE']	clit=opt
P	['ACRO_EE']	clit=opt
P	['ACRO_EE']	clit=opt
P	['ACRO_EE']	clit=opt
P	['ACRO_EE']	clit=opt
P	['ACRO_EE']	clit=opt
P	['ACRO_EE']	clit=opt
P	['ACRO_EE']	clit=opt
P	['ACRO_EE']	clit=opt
P	['ACRO_EE']	clit=opt
P	['ACRO_EE']	clit=opt
P	['ACRO_EE']	clit=opt
P	['ACRO_EE']	clit=opt
P	['ACRO_EE']	clit=opt
P	['ACRO_EE']	clit=opt
P	['ACRO_EE']	clit=opt
P	['ACRO_EE']	clit=opt
P	['ACRO_EE']	clit=opt
P	['ACRO_EE']	clit=opt
P	['ACRO_EE']	clit=opt
P	['ACRO_EE']	clit=opt
P	['ACRO_EE']	clit=opt
P	['ACRO_EE']	clit=opt
P	['ACRO_EE']	clit=opt
P	['ACRO_EE']	clit=opt
P	['ACRO_EE']	clit=opt
P	['ACRO_EE']	clit=opt
P	['ACRO_EE']	clit=opt
P	['ACRO_EE']	clit=opt
P	['ACRO_EE']	clit=opt
P	['ACRO_EE']	clit=opt
P	['ACRO_EE']	clit=opt
P	['ACRO_EE']	clit=opt
P	['ACRO_EE']	clit=opt
P	['ACRO_EE']	clit=opt
P	['ACRO_EE']	clit=opt
P	['ACRO_EE']	clit=opt
P	['ACRO_EE']	clit=opt
P	['ACRO_EE']	poss=opt
P	['ACRO_EE']	poss=opt
P	['ACRO_EE']	clit=opt
P	['ACRO_EE']	poss=opt
P	['ACRO_EE']	clit=opt
P	['ACRO_EE']	clit=opt
P	['ACRO_EE']	poss=opt
P	['ACRO_EE']	poss=opt
P	['ACRO_EE']	clit=opt
P	['ACRO_EE']	clit=opt
P	['ACRO_EE']	clit=opt
P	['ACRO_EE']	clit=opt
P	['ACRO_EE']	clit=opt
P	['ACRO_EE']	clit=opt
P	['ACRO_EE']	clit=opt
P	['ACRO_EE']	clit=opt
P	['ACRO_EE']	clit=opt
P	['ACRO_EE']	clit=opt
P	['ACRO_EE']	clit=opt
P	['ACRO_EE']	clit=opt
P	['ACRO_EE']	clit=opt
P	['ACRO_EE']	clit=opt
P	['ACRO_EE']	poss=opt
P	['ACRO_EE']	poss=opt
P	['ACRO_EE']	clit=opt
P	['ACRO_EE']	clit=opt
P	['ACRO_EE']	clit=opt
P	['ACRO_EE']	clit=opt
P	['ACRO_EE']	clit=opt
P	['ACRO_EE']	clit=opt
P	['ACRO_EE']	clit=opt
P	['ACRO_EE']	poss=opt
P	['ACRO_EE']	clit=opt
P	['ACRO_EE']	poss=opt
P	['ACRO_EE']	clit=opt
P	['ACRO_EE']	clit=opt
P	['ACRO_EE']	clit=opt
P	['ACRO_EE']	clit=opt
P	['ACRO_EE']	clit=opt
P	['ACRO_EE']	clit=opt
P	['ACRO_EE']	clit=opt
P	['ACRO_EE']	clit=opt
P	['ACRO_EE']	clit=opt
P	['ACRO_EE']	clit=opt
P	['ACRO_EE']	clit=opt
P	['ACRO_EE']	clit=opt
P	['ACRO_EE']	clit=opt
P	['ACRO_EE']	poss=opt
P	['ACRO_EE']	poss=opt
P	['ACRO_EE']	clit=opt
P	['ACRO_EE']	clit=opt
P	['ACRO_EE']	clit=opt
P	['ACRO_EE']	poss=opt
P	['ACRO_EE']	poss=opt
P	['ACRO_EE']	poss=opt
P	['ACRO_EE']	clit=opt
P	['ACRO_EE']	clit=opt
P	['ACRO_EE']	clit=opt
P	['ACRO_EE']	clit=opt
P	['ACRO_EE']	poss=opt
P	['ACRO_EE']	poss=obl
P	['ACRO_EE']	clit=opt
P	['ACRO_EE']	clit=opt
P	['ACRO_EE']	clit=opt
P	['ACRO_EE']	clit=opt
P	['ACRO_EE']	clit=opt
P	['ACRO_EE']	clit=opt
P	['ACRO_EE']	clit=opt
P	['ACRO_EE']	clit=opt
P	['ACRO_EE']	clit=opt
P	['ACRO_EE']	clit=opt
P	['ACRO_EE']	clit=opt
P	['ACRO_EE']	clit=opt
P	['ACRO_EE']	clit=opt
P	['ACRO_EE']	clit=opt
P	['ACRO_EE']	clit=opt
P	['ACRO_EE']	clit=opt
P	['ACRO_EE']	clit=opt
P	['ACRO_EE']	clit=opt
P	['ACRO_EE']	clit=opt
P	['ACRO_EE']	clit=opt
P	['ACRO_EE']	poss=opt
P	['ACRO_EE']	clit=opt
P	['ACRO_EE']	clit=opt
P	['ACRO_EE']	clit=opt
P	['ACRO_EE']	clit=opt
P	['ACRO_EE']	clit=opt
P	['ACRO_EE']	clit=opt
P	['ACRO_EE']	clit=opt
P	['ACRO_EE']	clit=opt
P	['ACRO_EE']	poss=opt
P	['ACRO_EE']	poss=opt
P	['ACRO_EE']	clit=opt
P	['ACRO_EE']	clit=opt
P	['ACRO_EE']	clit=opt
P	['ACRO_EE']	clit=opt
P	['ACRO_EE']	clit=opt
P	['ACRO_EE']	clit=opt
P	['ACRO_EE']	clit=opt
P	['ACRO_EE']	clit=opt
P	['ACRO_EE']	clit=opt
P	['ACRO_EE']	clit=opt
P	['ACRO_EE']	clit=opt
P	['ACRO_EE']	clit=opt
P	['ACRO_EE']	clit=opt
P	['ACRO_EE']	clit=opt
P	['ACRO_EE']	clit=opt
P	['ACRO_EE']	clit=opt
P	['ACRO_EE']	clit=opt
P	['ACRO_EE']	clit=opt
P	['ACRO_EE']	poss=opt
P	['ACRO_EE']	clit=opt
P	['ACRO_EE']	clit=opt
P	['ACRO_EE']	clit=opt
P	['ACRO_EE']	clit=opt
P	['ACRO_EE']	clit=opt
P	['ACRO_EE']	poss=opt
P	['ACRO_EE']	clit=opt
P	['ACRO_EE']	clit=opt
P	['ACRO_EE']	clit=opt
P	['ACRO_EE']	clit=opt
P	['ACRO_EE']	clit=opt
P	['ACRO_EE']	clit=opt
P	['ACRO_EE']	clit=opt
P	['ACRO_EE']	clit=opt
P	['ACRO_EE']	clit=opt
P	['ACRO_EE']	clit=opt
P	['ACRO_EE']	clit=opt
P	['ACRO_EE']	poss=opt
P	['ACRO_EE']	poss=opt
P	['ACRO_EE']	poss=opt
P	['ACRO_EE']	poss=opt
P	['ACRO_EE']	poss=opt
P	['ACRO_EE']	clit=opt
P	['ACRO_EE']	poss=opt
P	['ACRO_EE']	clit=opt
P	['ACRO_EE']	clit=opt
P	['ACRO_EE']	clit=opt
P	['ACRO_EE']	clit=opt
P	['ACRO_EE']	clit=opt
P	['ACRO_EE']	clit=opt
P	['ACRO_EE']	clit=opt
P	['ACRO_EE']	clit=opt
P	['ACRO_EE']	clit=opt
P	['ACRO_EE']	clit=opt
P	['ACRO_EE']	clit=opt
P	['ACRO_EE']	clit=opt
P	['ACRO_EE']	clit=opt
P	['ACRO_EE']	clit=opt
P	['ACRO_EE']	clit=opt
P	['ACRO_EE']	poss=opt
P	['ACRO_EE']	clit=opt
P	['ACRO_EE']	clit=opt
P	['ACRO_EE']	clit=opt
P	['ACRO_EE']	clit=opt
P	['ACRO_EE']	clit=opt
P	['ACRO_EE']	clit=opt
P	['ACRO_EE']	clit=opt
P	['ACRO_EE']	clit=opt
P	['ACRO_EE']	clit=opt
P	['ACRO_EE']	clit=opt
P	['ACRO_EE']	clit=opt
P	['ACRO_EE']	clit=opt
P	['ACRO_EE']	clit=opt
P	['ACRO_EE']	clit=opt
P	['ACRO_EE']	clit=opt
P	['ACRO_EE']	clit=opt
P	['ACRO_EE']	clit=opt
P	['ACRO_EE']	clit=opt
P	['ACRO_EE']	poss=opt
P	['ACRO_EE']	poss=opt
P	['ACRO_EE']	clit=opt
P	['ACRO_EE']	clit=opt
P	['ACRO_EE']	clit=opt
P	['ACRO_EE']	clit=opt
P	['ACRO_EE']	clit=opt
P	['ACRO_EE']	clit=opt
P	['ACRO_EE']	clit=opt
P	['ACRO_EE']	clit=opt
P	['ACRO_EE']	clit=opt
P	['ACRO_EE']	clit=opt
P	['ACRO_EE']	clit=opt
P	['ACRO_EE']	clit=opt
P	['ACRO_EE']	clit=opt
P	['ACRO_EE']	clit=opt
P	['ACRO_EE']	clit=opt
P	['ACRO_EE']	clit=opt
P	['ACRO_EE']	poss=opt
P	['ACRO_EE']	poss=opt
P	['ACRO_EE']	poss=opt
P	['ACRO_EE']	clit=opt
P	['ACRO_EE']	clit=opt
P	['ACRO_EE']	clit=opt
P	['ACRO_EE']	clit=opt
P	['ACRO_EE']	clit=opt
P	['ACRO_EE']	clit=opt
P	['ACRO_EE']	clit=opt
P	['ACRO_EE']	clit=opt
P	['ACRO_EE']	clit=opt
P	['ACRO_EE']	clit=opt
P	['ACRO_EE']	clit=opt
P	['ACRO_EE']	clit=opt
P	['ACRO_EE']	clit=opt
P	['ACRO_EE']	clit=opt
P	['ACRO_EE']	clit=opt
P	['ACRO_EE']	clit=opt
P	['ACRO_EE']	clit=opt
P	['ACRO_EE']	poss=opt
P	['ACRO_EE']	clit=opt
P	['ACRO_EE']	clit=opt
P	['ACRO_EE']	clit=opt
P	['ACRO_EE']	poss=opt
P	['ACRO_EE']	clit=opt
P	['ACRO_EE']	clit=opt
P	['ACRO_EE']	clit=opt
P	['ACRO_EE']	clit=opt
P	['ACRO_EE']	clit=opt
P	['ACRO_EE']	clit=opt
P	['ACRO_EE']	clit=opt
P	['ACRO_EE']	clit=opt
P	['ACRO_EE']	clit=opt
P	['ACRO_EE']	poss=opt
P	['ACRO_EE']	clit=opt
P	['ACRO_EE']	poss=opt
P	['ACRO_EE']	poss=opt
P	['ACRO_EE']	clit=opt
P	['ACRO_EE']	clit=opt
P	['ACRO_EE']	clit=opt
P	['ACRO_EE']	clit=opt
P	['ACRO_EE']	clit=opt
P	['ACRO_EE']	clit=opt
P	['ACRO_EE']	clit=opt
P	['ACRO_EE']	clit=opt
P	['ACRO_EE']	poss=opt
P	['ACRO_EE']	clit=opt
P	['ACRO_EE']	clit=opt
P	['ACRO_EE']	clit=opt
P	['ACRO_EE']	clit=opt
P	['ACRO_EE']	clit=opt
P	['ACRO_EE']	clit=opt
P	['ACRO_EE']	clit=opt
P	['ACRO_EE']	clit=opt
P	['ACRO_EE']	clit=opt
P	['ACRO_EE']	poss=opt
P	['ACRO_EE']	poss=opt
P	['ACRO_EE']	clit=opt
P	['ACRO_EE']	poss=opt
P	['ACRO_EE']	clit=opt
P	['ACRO_EE']	clit=opt
P	['ACRO_EE']	clit=opt
P	['ACRO_EE']	clit=opt
P	['ACRO_EE']	clit=opt
P	['ACRO_EE']	clit=opt
P	['ACRO_EE']	clit=opt
P	['ACRO_EE']	clit=opt
P	['ACRO_EE']	clit=opt
P	['ACRO_EE']	clit=opt
P	['ACRO_EE']	clit=opt
P	['ACRO_EE']	clit=opt
P	['ACRO_EE']	poss=opt
P	['ACRO_EE']	poss=opt
P	['ACRO_EE']	poss=opt
P	['ACRO_EE']	poss=opt
P	['ACRO_EE']	poss=obl
P	['ACRO_EE']	poss=opt
P	['ACRO_EE']	clit=opt
P	['ACRO_EE']	clit=opt
P	['ACRO_EE']	clit=opt
P	['ACRO_EE']	poss=opt
P	['ACRO_EE']	poss=opt
P	['ACRO_EE']	clit=opt
P	['ACRO_EE']	clit=opt
P	['ACRO_EE']	clit=opt
P	['ACRO_EE']	clit=opt
P	['ACRO_EE']	clit=opt
P	['ACRO_EE']	poss=opt
P	['ACRO_EE']	clit=opt
P	['ACRO_EE']	clit=opt
P	['ACRO_EE']	clit=opt
P	['ACRO_EE']	clit=opt
P	['ACRO_EE']	clit=opt
P	['ACRO_EE']	clit=opt
P	['ACRO_EE']	clit=opt
P	['ACRO_EE']	clit=opt
P	['ACRO_EE']	clit=opt
P	['ACRO_EE']	clit=opt
P	['ACRO_EE']	clit=opt
P	['ACRO_EE']	clit=opt
P	['ACRO_EE']	clit=opt
P	['ACRO_EE']	clit=opt
P	['ACRO_EE']	clit=opt
P	['ACRO_EE']	clit=opt
P	['ACRO_EE']	clit=opt
P	['ACRO_EE']	clit=opt
P	['ACRO_EE']	clit=opt
P	['ACRO_EE']	clit=opt
P	['ACRO_EE']	clit=opt
P	['ACRO_EE']	clit=opt
P	['ACRO_EE']	clit=opt
P	['ACRO_EE']	clit=opt
P	['ACRO_EE']	clit=opt
P	['ACRO_EE']	clit=opt
P	['ACRO_EE']	clit=opt
P	['ACRO_EE']	clit=opt
P	['ACRO_EE']	clit=opt
P	['ACRO_EE']	poss=opt
P	['ACRO_EE']	poss=opt
P	['ACRO_EE']	poss=opt
P	['ACRO_EE']	clit=opt
P	['ACRO_EE']	clit=opt
P	['ACRO_EE']	clit=opt
P	['ACRO_EE']	clit=opt
P	['ACRO_EE']	clit=opt
P	['ACRO_EE']	clit=opt
P	['ACRO_EE']	clit=opt
P	['ACRO_EE']	clit=opt
P	['ACRO_EE']	clit=opt
P	['ACRO_EE']	clit=opt
P	['ACRO_EE']	clit=opt
P	['ACRO_EE']	clit=opt
P	['ACRO_EE']	clit=opt
P	['ACRO_EE']	clit=opt
P	['ACRO_EE']	clit=opt
P	['ACRO_EE']	clit=opt
P	['ACRO_EE']	clit=opt
P	['ACRO_EE']	clit=opt
P	['ACRO_EE']	clit=opt
P	['ACRO_EE']	clit=opt
P	['ACRO_EE']	clit=opt
P	['ACRO_EE']	clit=opt
P	['ACRO_EE']	clit=opt
P	['ACRO_EE']	clit=opt
P	['ACRO_EE']	clit=opt
P	['ACRO_EE']	clit=opt
P	['ACRO_EE']	clit=opt
P	['ACRO_EE']	clit=opt
P	['ACRO_EE']	poss=opt
P	['ACRO_EE']	poss=opt
P	['ACRO_EE']	poss=opt
P	['ACRO_EE']	clit=opt
P	['ACRO_EE']	clit=opt
P	['ACRO_EE']	clit=opt
P	['ACRO_EE']	clit=opt
P	['ACRO_EE']	clit=opt
P	['ACRO_EE']	clit=opt
P	['ACRO_EE']	clit=opt
P	['ACRO_EE']	clit=opt
P	['ACRO_EE']	clit=opt
P	['ACRO_EE']	clit=opt
P	['ACRO_EE']	clit=opt
P	['ACRO_EE']	clit=opt
P	['ACRO_EE']	clit=opt
P	['ACRO_EE']	clit=opt
P	['ACRO_EE']	clit=opt
P	['ACRO_EE']	clit=opt
P	['ACRO_EE']	clit=opt
P	['ACRO_EE']	clit=opt
P	['ACRO_EE']	clit=opt
P	['ACRO_EE']	clit=opt
P	['ACRO_EE']	clit=opt
P	['ACRO_EE']	clit=opt
P	['ACRO_EE']	clit=opt
P	['ACRO_EE']	poss=opt
P	['ACRO_EE']	clit=opt
P	['ACRO_EE']	clit=opt
P	['ACRO_EE']	poss=opt
P	['ACRO_EE']	clit=opt
P	['ACRO_EE']	clit=opt
P	['ACRO_EE']	clit=opt
P	['ACRO_EE']	clit=opt
P	['ACRO_EE']	clit=opt
P	['ACRO_EE']	clit=opt
P	['ACRO_EE']	clit=opt
P	['ACRO_EE']	clit=opt
P	['ACRO_EE']	clit=opt
P	['ACRO_EE']	clit=opt
P	['ACRO_EE']	clit=opt
P	['ACRO_EE']	clit=opt
P	['ACRO_EE']	clit=opt
P	['ACRO_EE']	clit=opt
P	['ACRO_EE']	clit=opt
P	['ACRO_EE']	clit=opt
P	['ACRO_EE']	clit=opt
P	['ACRO_EE']	clit=opt
P	['ACRO_EE']	clit=opt
P	['ACRO_EE']	clit=opt
P	['ACRO_EE']	clit=opt
P	['ACRO_EE']	clit=opt
P	['ACRO_EE']	clit=opt
P	['ACRO_EE']	clit=opt
P	['ACRO_EE']	clit=opt
P	['ACRO_EE']	clit=opt
P	['ACRO_EE']	clit=opt
P	['ACRO_EE']	clit=opt
P	['ACRO_EE']	clit=opt
P	['ACRO_EE']	clit=opt
P	['ACRO_EE']	clit=opt
P	['ACRO_EE']	clit=opt
P	['ACRO_EE']	clit=opt
P	['ACRO_EE']	clit=opt
P	['ACRO_EE']	clit=opt
P	['ACRO_EE']	clit=opt
P	['ACRO_EE']	clit=opt
P	['ACRO_EE']	poss=opt
P	['ACRO_EE']	clit=opt
P	['ACRO_EE']	clit=opt
P	['ACRO_EE']	poss=opt
P	['ACRO_EE']	clit=opt
P	['ACRO_EE']	clit=opt
P	['ACRO_EE']	poss=opt
P	['ACRO_EE']	clit=opt
P	['ACRO_EE']	clit=opt
P	['ACRO_EE']	clit=opt
P	['ACRO_EE']	clit=opt
P	['ACRO_EE']	clit=opt
P	['ACRO_EE']	clit=opt
P	['ACRO_EE']	clit=opt
P	['ACRO_EE']	clit=opt
P	['ACRO_EE']	clit=opt
P	['ACRO_EE']	clit=opt
P	['ACRO_EE']	clit=opt
P	['ACRO_EE']	clit=opt
P	['ACRO_EE']	clit=opt
P	['ACRO_EE']	clit=opt
P	['ACRO_EE']	clit=opt
P	['ACRO_EE']	clit=opt
P	['ACRO_EE']	clit=opt
P	['ACRO_EE']	poss=opt
P	['ACRO_EE']	poss=opt
P	['ACRO_EE']	clit=opt
P	['ACRO_EE']	clit=opt
P	['ACRO_EE']	clit=opt
P	['ACRO_EE']	clit=opt
P	['ACRO_EE']	clit=opt
P	['ACRO_EE']	clit=opt
P	['ACRO_EE']	clit=opt
P	['ACRO_EE']	clit=opt
P	['ACRO_EE']	clit=opt
P	['ACRO_EE']	clit=opt
P	['ACRO_EE']	clit=opt
P	['ACRO_EE']	poss=opt
P	['ACRO_EE']	clit=opt
P	['ACRO_EE']	clit=opt
P	['ACRO_EE']	clit=opt
P	['ACRO_EE']	clit=opt
P	['ACRO_EE']	clit=opt
P	['ACRO_EE']	clit=opt
P	['ACRO_EE']	clit=opt
P	['ACRO_EE']	clit=opt
P	['ACRO_EE']	clit=opt
P	['ACRO_EE']	clit=opt
P	['ACRO_EE']	clit=opt
P	['ACRO_EE']	clit=opt
P	['ACRO_EE']	clit=opt
P	['ACRO_EE']	clit=opt
P	['ACRO_EE']	clit=opt
P	['ACRO_EE']	clit=opt
P	['ACRO_EE']	clit=opt
P	['ACRO_EE']	clit=opt
P	['ACRO_EE']	clit=opt
P	['ACRO_EE']	clit=opt
P	['ACRO_EE']	clit=opt
P	['ACRO_EE']	clit=opt
P	['ACRO_EE']	clit=opt
P	['ACRO_EE']	clit=opt
P	['ACRO_EE']	clit=opt
P	['ACRO_EE']	clit=opt
P	['ACRO_EE']	clit=opt
P	['ACRO_EE']	clit=opt
P	['ACRO_EE']	clit=opt
P	['ACRO_EE']	clit=opt
P	['ACRO_EE']	clit=opt
P	['ACRO_EE']	clit=opt
P	['ACRO_EE']	clit=opt
P	['ACRO_EE']	clit=opt
P	['ACRO_EE']	clit=opt
P	['ACRO_EE']	clit=opt
P	['ACRO_EE']	clit=opt
P	['ACRO_EE']	clit=opt
P	['ACRO_EE']	clit=opt
P	['ACRO_EE']	clit=opt
P	['ACRO_EE']	clit=opt
P	['ACRO_EE']	poss=opt
P	['ACRO_EE']	clit=opt
P	['ACRO_EE']	clit=opt
P	['ACRO_EE']	clit=opt
P	['ACRO_EE']	poss=opt
P	['ACRO_EE']	clit=opt
P	['ACRO_EE']	poss=opt
P	['ACRO_EE']	poss=opt
P	['ACRO_EE']	poss=opt
P	['ACRO_EE']	clit=opt
P	['ACRO_EE']	clit=opt
P	['ACRO_EE']	poss=opt
P	['ACRO_EE']	clit=opt
P	['ACRO_EE']	clit=opt
P	['ACRO_EE']	clit=opt
P	['ACRO_EE']	clit=opt
P	['ACRO_EE']	clit=opt
P	['ACRO_EE']	clit=opt
P	['ACRO_EE']	clit=opt
P	['ACRO_EE']	clit=opt
P	['ACRO_EE']	clit=opt
P	['ACRO_EE']	clit=opt
P	['ACRO_EE']	clit=opt
P	['ACRO_EE']	clit=opt
P	['ACRO_EE']	poss=opt
P	['ACRO_EE']	poss=opt
P	['ACRO_EE']	clit=opt
P	['ACRO_EE']	clit=opt
P	['ACRO_EE']	clit=opt
P	['ACRO_EE']	clit=opt
P	['ACRO_EE']	clit=opt
P	['ACRO_EE']	clit=opt
P	['ACRO_EE']	clit=opt
P	['ACRO_EE']	clit=opt
P	['ACRO_EE']	clit=opt
P	['ACRO_EE']	clit=opt
P	['ACRO_EE']	clit=opt
P	['ACRO_EE']	clit=opt
P	['ACRO_EE']	clit=opt
P	['ACRO_EE']	clit=opt
P	['ACRO_EE']	clit=opt
P	['ACRO_EE']	clit=opt
P	['ACRO_EE']	poss=opt
P	['ACRO_EE']	poss=opt
P	['ACRO_EE']	poss=opt
P	['ACRO_EE']	poss=opt
P	['ACRO_EE']	poss=opt
P	['ACRO_EE']	poss=opt
P	['ACRO_EE']	clit=opt
P	['ACRO_EE']	poss=opt
P	['ACRO_EE']	clit=opt
P	['ACRO_EE']	clit=opt
P	['ACRO_EE']	clit=opt
P	['ACRO_EE']	clit=opt
P	['ACRO_EE']	clit=opt
P	['ACRO_EE']	clit=opt
P	['ACRO_EE']	clit=opt
P	['ACRO_EE']	clit=opt
P	['ACRO_EE']	clit=opt
P	['ACRO_EE']	clit=opt
P	['ACRO_EE']	clit=opt
P	['ACRO_EE']	poss=opt
P	['ACRO_EE']	clit=opt
P	['ACRO_EE']	poss=opt
P	['ACRO_EE']	clit=opt
P	['ACRO_EE']	clit=opt
P	['ACRO_EE']	clit=opt
P	['ACRO_EE']	clit=opt
P	['ACRO_EE']	clit=opt
P	['ACRO_EE']	clit=opt
P	['ACRO_EE']	clit=opt
P	['ACRO_EE']	clit=opt
P	['ACRO_EE']	clit=opt
P	['ACRO_EE']	clit=opt
P	['ACRO_EE']	clit=opt
P	['ACRO_EE']	clit=opt
P	['ACRO_EE']	clit=opt
P	['ACRO_EE']	clit=opt
P	['ACRO_EE']	clit=opt
P	['ACRO_EE']	clit=opt
P	['ACRO_EE']	clit=opt
P	['ACRO_EE']	poss=opt
P	['ACRO_EE']	poss=opt
P	['ACRO_EE']	clit=opt
P	['ACRO_EE']	clit=opt
P	['ACRO_EE']	clit=opt
P	['ACRO_EE']	clit=opt
P	['ACRO_EE']	clit=opt
P	['ACRO_EE']	clit=opt
P	['ACRO_EE']	clit=opt
P	['ACRO_EE']	clit=opt
P	['ACRO_EE']	clit=opt
P	['ACRO_EE']	clit=opt
P	['ACRO_EE']	clit=opt
P	['ACRO_EE']	clit=opt
P	['ACRO_EE']	clit=opt
P	['ACRO_EE']	clit=opt
P	['ACRO_EE']	clit=opt
P	['ACRO_EE']	clit=opt
P	['ACRO_EE']	clit=opt
P	['ACRO_EE']	clit=opt
P	['ACRO_EE']	clit=opt
P	['ACRO_EE']	clit=opt
P	['ACRO_EE']	clit=opt
P	['ACRO_EE']	clit=opt
P	['ACRO_EE']	clit=opt
P	['ACRO_EE']	clit=opt
P	['ACRO_EE']	clit=opt
P	['ACRO_EE']	clit=opt
P	['ACRO_EE']	clit=opt
P	['ACRO_EE']	clit=opt
P	['ACRO_EE']	clit=opt
P	['ACRO_EE']	clit=opt
P	['ACRO_EE']	clit=opt
P	['ACRO_EE']	clit=opt
P	['ACRO_EE']	clit=opt
P	['ACRO_EE']	clit=opt
P	['ACRO_EE']	clit=opt
P	['ACRO_EE']	clit=opt
P	['ACRO_EE']	poss=opt
P	['ACRO_EE']	clit=opt
P	['ACRO_EE']	clit=opt
P	['ACRO_EE']	clit=opt
P	['ACRO_EE']	clit=opt
P	['ACRO_EE']	clit=opt
P	['ACRO_EE']	clit=opt
P	['ACRO_EE']	clit=opt
P	['ACRO_EE']	clit=opt
P	['ACRO_EE']	clit=opt
P	['ACRO_EE']	clit=opt
P	['ACRO_EE']	clit=opt
P	['ACRO_EE']	clit=opt
P	['ACRO_EE']	clit=opt
P	['ACRO_EE']	clit=opt
P	['ACRO_EE']	clit=opt
P	['ACRO_EE']	clit=opt
P	['ACRO_EE']	poss=opt
P	['ACRO_EE']	clit=opt
P	['ACRO_EE']	poss=opt
P	['ACRO_EE']	poss=obl
P	['ACRO_EE']	clit=opt
P	['ACRO_EE']	poss=opt
P	['ACRO_EE']	clit=opt
P	['ACRO_EE']	clit=opt
P	['ACRO_EE']	clit=opt
P	['ACRO_EE']	clit=opt
P	['ACRO_EE']	clit=opt
P	['ACRO_EE']	clit=opt
P	['ACRO_EE']	clit=opt
P	['ACRO_EE']	poss=opt
P	['ACRO_EE']	poss=opt
P	['ACRO_EE']	clit=opt
P	['ACRO_EE']	clit=opt
P	['ACRO_EE']	clit=opt
P	['ACRO_EE']	poss=opt
P	['ACRO_EE']	clit=opt
P	['ACRO_EE']	clit=opt
P	['ACRO_EE']	clit=opt
P	['ACRO_EE']	clit=opt
P	['ACRO_EE']	clit=opt
P	['ACRO_EE']	clit=opt
P	['ACRO_EE']	clit=opt
P	['ACRO_EE']	clit=opt
P	['ACRO_EE']	poss=opt
P	['ACRO_EE']	poss=opt
P	['ACRO_EE']	poss=opt
P	['ACRO_EE']	clit=opt
P	['ACRO_EE']	clit=opt
P	['ACRO_EE']	clit=opt
P	['ACRO_EE']	clit=opt
P	['ACRO_EE']	clit=opt
P	['ACRO_EE']	clit=opt
P	['ACRO_EE']	clit=opt
P	['ACRO_EE']	clit=opt
P	['ACRO_EE']	clit=opt
P	['ACRO_EE']	clit=opt
P	['ACRO_EE']	clit=opt
P	['ACRO_EE']	clit=opt
P	['ACRO_EE']	clit=opt
P	['ACRO_EE']	clit=opt
P	['ACRO_EE']	clit=opt
P	['ACRO_EE']	clit=opt
P	['ACRO_EE']	clit=opt
P	['ACRO_EE']	clit=opt
P	['ACRO_EE']	clit=opt
P	['ACRO_EE']	clit=opt
P	['ACRO_EE']	clit=opt
P	['ACRO_EE']	clit=opt
P	['ACRO_EE']	clit=opt
P	['ACRO_EE']	clit=opt
P	['ACRO_EE']	clit=opt
P	['ACRO_EE']	clit=opt
P	['ACRO_EE']	poss=opt
P	['ACRO_EE']	clit=opt
P	['ACRO_EE']	clit=opt
P	['ACRO_EE']	clit=opt
P	['ACRO_EE']	clit=opt
P	['ACRO_EE']	clit=opt
P	['ACRO_EE']	clit=opt
P	['ACRO_EE']	clit=opt
P	['ACRO_EE']	clit=opt
P	['ACRO_EE']	clit=opt
P	['ACRO_EE']	clit=opt
P	['ACRO_EE']	clit=opt
P	['ACRO_EE']	clit=opt
P	['ACRO_EE']	clit=opt
P	['ACRO_EE']	clit=opt
P	['ACRO_EE']	clit=opt
P	['ACRO_EE']	clit=opt
P	['ACRO_EE']	poss=obl
P	['ACRO_EE']	poss=opt
P	['ACRO_EE']	poss=opt
P	['ACRO_EE']	clit=opt
P	['ACRO_EE']	clit=opt
P	['ACRO_EE']	clit=opt
P	['ACRO_EE']	poss=opt
P	['ACRO_EE']	clit=opt
P	['ACRO_EE']	clit=opt
P	['ACRO_EE']	clit=opt
P	['ACRO_EE']	clit=opt
P	['ACRO_EE']	clit=opt
P	['ACRO_EE']	clit=opt
P	['ACRO_EE']	clit=opt
P	['ACRO_EE']	clit=opt
P	['ACRO_EE']	clit=opt
P	['ACRO_EE']	clit=opt
P	['ACRO_EE']	clit=opt
P	['ACRO_EE']	clit=opt
P	['ACRO_EE']	clit=opt
P	['ACRO_EE']	clit=opt
P	['ACRO_EE']	clit=opt
P	['ACRO_EE']	clit=opt
P	['ACRO_EE']	poss=opt
P	['ACRO_EE']	clit=opt
P	['ACRO_EE']	poss=opt
P	['ACRO_EE']	clit=opt
P	['ACRO_EE']	clit=opt
P	['ACRO_EE']	clit=opt
P	['ACRO_EE']	clit=opt
P	['ACRO_EE']	poss=obl
P	['ACRO_EE']	clit=opt
P	['ACRO_EE']	clit=opt
P	['ACRO_EE']	poss=opt
P	['ACRO_EE']	poss=opt
P	['ACRO_EE']	clit=opt
P	['ACRO_EE']	poss=opt
P	['ACRO_EE']	poss=opt
P	['ACRO_EE']	poss=opt
P	['ACRO_EE']	clit=opt
P	['ACRO_EE']	clit=opt
P	['ACRO_EE']	clit=opt
P	['ACRO_EE']	clit=opt
P	['ACRO_EE']	clit=opt
P	['ACRO_EE']	clit=opt
P	['ACRO_EE']	clit=opt
P	['ACRO_EE']	poss=opt
P	['ACRO_EE']	poss=obl
P	['ACRO_EE']	clit=opt
P	['ACRO_EE']	clit=opt
P	['ACRO_EE']	clit=opt
P	['ACRO_EE']	clit=opt
P	['ACRO_EE']	clit=opt
P	['ACRO_EE']	clit=opt
P	['ACRO_EE']	clit=opt
P	['ACRO_EE']	clit=opt
P	['ACRO_EE']	clit=opt
P	['ACRO_EE']	clit=opt
P	['ACRO_EE']	poss=opt
P	['ACRO_EE']	poss=opt
P	['ACRO_EE']	poss=opt
P	['ACRO_EE']	poss=opt
P	['ACRO_EE']	poss=opt
P	['ACRO_EE']	clit=opt
P	['ACRO_EE']	poss=opt
P	['ACRO_EE']	clit=opt
P	['ACRO_EE']	clit=opt
P	['ACRO_EE']	clit=opt
P	['ACRO_EE']	clit=opt
P	['ACRO_EE']	clit=opt
P	['ACRO_EE']	clit=opt
P	['ACRO_EE']	clit=opt
P	['ACRO_EE']	clit=opt
P	['ACRO_EE']	clit=opt
P	['ACRO_EE']	clit=opt
P	['ACRO_EE']	clit=opt
P	['ACRO_EE']	clit=opt
P	['ACRO_EE']	clit=opt
P	['ACRO_EE']	clit=opt
P	['ACRO_EE']	clit=opt
P	['ACRO_EE']	clit=opt
P	['ACRO_EE']	clit=opt
P	['ACRO_EE']	clit=opt
P	['ACRO_EE']	clit=opt
P	['ACRO_EE']	clit=opt
P	['ACRO_EE']	clit=opt
P	['ACRO_EE']	clit=opt
P	['ACRO_EE']	clit=opt
P	['ACRO_EE']	clit=opt
P	['ACRO_EE']	clit=opt
P	['ACRO_EE']	clit=opt
P	['ACRO_EE']	clit=opt
P	['ACRO_EE']	clit=opt
P	['ACRO_EE']	clit=opt
P	['ACRO_EE']	clit=opt
P	['ACRO_EE']	clit=opt
P	['ACRO_EE']	clit=opt
P	['ACRO_EE']	clit=opt
P	['ACRO_EE']	clit=opt
P	['ACRO_EE']	clit=opt
P	['ACRO_EE']	clit=opt
P	['ACRO_EE']	clit=opt
P	['ACRO_EE']	clit=opt
P	['ACRO_EE']	clit=opt
P	['ACRO_EE']	clit=opt
P	['ACRO_EE']	clit=opt
P	['ACRO_EE']	poss=opt
P	['ACRO_EE']	clit=opt
P	['ACRO_EE']	clit=opt
P	['ACRO_EE']	poss=opt
P	['ACRO_EE']	clit=opt
P	['ACRO_EE']	clit=opt
P	['ACRO_EE']	poss=opt
P	['ACRO_EE']	poss=opt
P	['ACRO_EE']	clit=opt
P	['ACRO_EE']	clit=opt
P	['ACRO_EE']	clit=opt
P	['ACRO_EE']	clit=opt
P	['ACRO_EE']	clit=opt
P	['ACRO_EE']	clit=opt
P	['ACRO_EE']	clit=opt
P	['ACRO_EE']	clit=opt
P	['ACRO_EE']	clit=opt
P	['ACRO_EE']	clit=opt
P	['ACRO_EE']	clit=opt
P	['ACRO_EE']	clit=opt
P	['ACRO_EE']	clit=opt
P	['ACRO_EE']	clit=opt
P	['ACRO_EE']	clit=opt
P	['ACRO_EE']	clit=opt
P	['ACRO_EE']	clit=opt
P	['ACRO_EE']	clit=opt
P	['ACRO_EE']	clit=opt
P	['ACRO_EE']	clit=opt
P	['ACRO_EE']	clit=opt
P	['ACRO_EE']	clit=opt
P	['ACRO_EE']	clit=opt
P	['ACRO_EE']	clit=opt
P	['ACRO_EE']	clit=opt
P	['ACRO_EE']	clit=opt
P	['ACRO_EE']	clit=opt
P	['ACRO_EE']	clit=opt
P	['ACRO_EE']	clit=opt
P	['ACRO_EE']	clit=opt
P	['ACRO_EE']	clit=opt
P	['ACRO_EE']	clit=opt
P	['ACRO_EE']	clit=opt
P	['ACRO_EE']	clit=opt
P	['ACRO_EE']	clit=opt
P	['ACRO_EE']	clit=opt
P	['ACRO_EE']	clit=opt
P	['ACRO_EE']	clit=opt
P	['ACRO_EE']	clit=opt
P	['ACRO_EE']	poss=opt
P	['ACRO_EE']	clit=opt
P	['ACRO_EE']	poss=opt
P	['ACRO_EE']	poss=opt
P	['ACRO_EE']	poss=opt
P	['ACRO_EE']	clit=opt
P	['ACRO_EE']	clit=opt
P	['ACRO_EE']	clit=opt
P	['ACRO_EE']	clit=opt
P	['ACRO_EE']	clit=opt
P	['ACRO_EE']	clit=opt
P	['ACRO_EE']	clit=opt
P	['ACRO_EE']	poss=opt
P	['ACRO_EE']	poss=opt
P	['ACRO_EE']	poss=opt
P	['ACRO_EE']	clit=opt
P	['ACRO_EE']	poss=opt
P	['ACRO_EE']	poss=opt
P	['ACRO_EE']	poss=opt
P	['ACRO_EE']	poss=opt
P	['ACRO_EE']	clit=opt
P	['ACRO_EE']	poss=opt
P	['ACRO_EE']	poss=opt
P	['ACRO_EE']	clit=opt
P	['ACRO_EE']	clit=opt
P	['ACRO_EE']	clit=opt
P	['ACRO_EE']	clit=opt
P	['ACRO_EE']	clit=opt
P	['ACRO_EE']	clit=opt
P	['ACRO_EE']	clit=opt
P	['ACRO_EE']	clit=opt
P	['ACRO_EE']	clit=opt
P	['ACRO_EE']	clit=opt
P	['ACRO_EE']	clit=opt
P	['ACRO_EE']	clit=opt
P	['ACRO_EE']	clit=opt
P	['ACRO_EE']	clit=opt
P	['ACRO_EE']	clit=opt
P	['ACRO_EE']	clit=opt
P	['ACRO_EE']	clit=opt
P	['ACRO_EE']	clit=opt
P	['ACRO_EE']	clit=opt
P	['ACRO_EE']	clit=opt
P	['ACRO_EE']	clit=opt
P	['ACRO_EE']	clit=opt
P	['ACRO_EE']	clit=opt
P	['ACRO_EE']	clit=opt
P	['ACRO_EE']	clit=opt
P	['ACRO_EE']	clit=opt
P	['ACRO_EE']	clit=opt
P	['ACRO_EE']	clit=opt
P	['ACRO_EE']	clit=opt
P	['ACRO_EE']	clit=opt
P	['ACRO_EE']	clit=opt
P	['ACRO_EE']	clit=opt
P	['ACRO_EE']	clit=opt
P	['ACRO_EE']	clit=opt
P	['ACRO_EE']	clit=opt
P	['ACRO_EE']	clit=opt
P	['ACRO_EE']	clit=opt
P	['ACRO_EE']	clit=opt
P	['ACRO_EE']	clit=opt
P	['ACRO_EE']	clit=opt
P	['ACRO_EE']	clit=opt
P	['ACRO_EE']	clit=opt
P	['ACRO_EE']	clit=opt
P	['ACRO_EE']	clit=opt
P	['ACRO_EE']	clit=opt
P	['ACRO_EE']	clit=opt
P	['ACRO_EE']	clit=opt
P	['ACRO_EE']	clit=opt
P	['ACRO_EE']	clit=opt
P	['ACRO_EE']	clit=opt
P	['ACRO_EE']	poss=opt
P	['ACRO_EE']	poss=opt
P	['ACRO_EE']	poss=opt
P	['ACRO_EE']	poss=opt
P	['ACRO_EE']	poss=opt
P	['ACRO_EE']	clit=opt
P	['ACRO_EE']	clit=opt
P	['ACRO_EE']	clit=opt
P	['ACRO_EE']	clit=opt
P	['ACRO_EE']	clit=opt
P	['ACRO_EE']	clit=opt
P	['ACRO_EE']	poss=opt
P	['ACRO_EE']	poss=opt
P	['ACRO_EE']	clit=opt
P	['ACRO_EE']	clit=opt
P	['ACRO_EE']	clit=opt
P	['ACRO_EE']	clit=opt
P	['ACRO_EE']	clit=opt
P	['ACRO_EE']	clit=opt
P	['ACRO_EE']	clit=opt
P	['ACRO_EE']	clit=opt
P	['ACRO_EE']	clit=opt
P	['ACRO_EE']	clit=opt
P	['ACRO_EE']	poss=opt
P	['ACRO_EE']	poss=opt
P	['ACRO_EE']	poss=opt
P	['ACRO_EE']	clit=opt
P	['ACRO_EE']	clit=opt
P	['ACRO_EE']	clit=opt
P	['ACRO_EE']	clit=opt
P	['ACRO_EE']	clit=opt
P	['ACRO_EE']	clit=opt
P	['ACRO_EE']	clit=opt
P	['ACRO_EE']	clit=opt
P	['ACRO_EE']	clit=opt
P	['ACRO_EE']	clit=opt
P	['ACRO_EE']	clit=opt
P	['ACRO_EE']	clit=opt
P	['ACRO_EE']	clit=opt
P	['ACRO_EE']	clit=opt
P	['ACRO_EE']	clit=opt
P	['ACRO_EE']	clit=opt
P	['ACRO_EE']	clit=opt
P	['ACRO_EE']	clit=opt
P	['ACRO_EE']	clit=opt
P	['ACRO_EE']	clit=opt
P	['ACRO_EE']	clit=opt
P	['ACRO_EE']	clit=opt
P	['ACRO_EE']	clit=opt
P	['ACRO_EE']	clit=opt
P	['ACRO_EE']	clit=opt
P	['ACRO_EE']	clit=opt
P	['ACRO_EE']	clit=opt
P	['ACRO_EE']	clit=opt
P	['ACRO_EE']	clit=opt
P	['ACRO_EE']	clit=opt
P	['ACRO_EE']	clit=opt
P	['ACRO_EE']	clit=opt
P	['ACRO_EE']	clit=opt
P	['ACRO_EE']	clit=opt
P	['ACRO_EE']	clit=opt
P	['ACRO_EE']	clit=opt
P	['ACRO_EE']	clit=opt
P	['ACRO_EE']	poss=opt
P	['ACRO_EE']	poss=opt
P	['ACRO_EE']	clit=opt
P	['ACRO_EE']	clit=opt
P	['ACRO_EE']	clit=opt
P	['ACRO_EE']	clit=opt
P	['ACRO_EE']	clit=opt
P	['ACRO_EE']	clit=opt
P	['ACRO_EE']	clit=opt
P	['ACRO_EE']	clit=opt
P	['ACRO_EE']	clit=opt
P	['ACRO_EE']	clit=opt
P	['ACRO_EE']	poss=opt
P	['ACRO_EE']	clit=opt
P	['ACRO_EE']	clit=opt
P	['ACRO_EE']	clit=opt
P	['ACRO_EE']	clit=opt
P	['ACRO_EE']	clit=opt
P	['ACRO_EE']	clit=opt
P	['ACRO_EE']	clit=opt
P	['ACRO_EE']	clit=opt
P	['ACRO_EE']	clit=opt
P	['ACRO_EE']	clit=opt
P	['ACRO_EE']	clit=opt
P	['ACRO_EE']	clit=opt
P	['ACRO_EE']	clit=opt
P	['ACRO_EE']	clit=opt
P	['ACRO_EE']	clit=opt
P	['ACRO_EE']	clit=opt
P	['ACRO_EE']	clit=opt
P	['ACRO_EE']	clit=opt
P	['ACRO_EE']	clit=opt
P	['ACRO_EE']	clit=opt
P	['ACRO_EE']	clit=opt
P	['ACRO_EE']	clit=opt
P	['ACRO_EE']	clit=opt
P	['ACRO_EE']	clit=opt
P	['ACRO_EE']	clit=opt
P	['ACRO_EE']	clit=opt
P	['ACRO_EE']	clit=opt
P	['ACRO_EE']	clit=opt
P	['ACRO_EE']	clit=opt
P	['ACRO_EE']	clit=opt
P	['ACRO_EE']	clit=opt
P	['ACRO_EE']	clit=opt
P	['ACRO_EE']	clit=opt
P	['ACRO_EE']	clit=opt
P	['ACRO_EE']	clit=opt
P	['ACRO_EE']	clit=opt
P	['ACRO_EE']	clit=opt
P	['ACRO_EE']	clit=opt
P	['ACRO_EE']	clit=opt
P	['ACRO_EE']	clit=opt
P	['ACRO_EE']	clit=opt
P	['ACRO_EE']	clit=opt
P	['ACRO_EE']	clit=opt
P	['ACRO_EE']	clit=opt
P	['ACRO_EE']	clit=opt
P	['ACRO_EE']	clit=opt
P	['ACRO_EE']	clit=opt
P	['ACRO_EE']	clit=opt
P	['ACRO_EE']	clit=opt
P	['ACRO_EE']	clit=opt
P	['ACRO_EE']	poss=opt
P	['ACRO_EE']	poss=opt
P	['ACRO_EE']	poss=opt
P	['ACRO_EE']	poss=opt
P	['ACRO_EE']	poss=opt
P	['ACRO_EE']	poss=opt
P	['ACRO_EE']	poss=opt
P	['ACRO_EE']	poss=opt
P	['ACRO_EE']	poss=obl
P	['ACRO_EE']	clit=opt
P	['ACRO_EE']	clit=opt
P	['ACRO_EE']	clit=opt
P	['ACRO_EE']	clit=opt
P	['ACRO_EE']	clit=opt
P	['ACRO_EE']	clit=opt
P	['ACRO_EE']	clit=opt
P	['ACRO_EE']	clit=opt
P	['ACRO_EE']	clit=opt
P	['ACRO_EE']	clit=opt
P	['ACRO_EE']	clit=opt
P	['ACRO_EE']	clit=opt
P	['ACRO_EE']	clit=opt
P	['ACRO_EE']	clit=opt
P	['ACRO_EE']	clit=opt
P	['ACRO_EE']	clit=opt
P	['ACRO_EE']	clit=opt
P	['ACRO_EE']	clit=opt
P	['ACRO_EE']	clit=opt
P	['ACRO_EE']	clit=opt
P	['ACRO_EE']	clit=opt
P	['ACRO_EE']	clit=opt
P	['ACRO_EE']	clit=opt
P	['ACRO_EE']	clit=opt
P	['ACRO_EE']	clit=opt
P	['ACRO_EE']	clit=opt
P	['ACRO_EE']	clit=opt
P	['ACRO_EE']	clit=opt
P	['ACRO_EE']	clit=opt
P	['ACRO_EE']	clit=opt
P	['ACRO_EE']	clit=opt
P	['ACRO_EE']	clit=opt
P	['ACRO_EE']	clit=opt
P	['ACRO_EE']	clit=opt
P	['ACRO_EE']	clit=opt
P	['ACRO_EE']	clit=opt
P	['ACRO_EE']	clit=opt
P	['ACRO_EE']	clit=opt
P	['ACRO_EE']	clit=opt
P	['ACRO_EE']	clit=opt
P	['ACRO_EE']	clit=opt
P	['ACRO_EE']	clit=opt
P	['ACRO_EE']	clit=opt
P	['ACRO_EE']	poss=opt
P	['ACRO_EE']	poss=opt
P	['ACRO_EE']	clit=opt
P	['ACRO_EE']	clit=opt
P	['ACRO_EE']	clit=opt
P	['ACRO_EE']	clit=opt
P	['ACRO_EE']	clit=opt
P	['ACRO_EE']	clit=opt
P	['ACRO_EE']	clit=opt
P	['ACRO_EE']	clit=opt
P	['ACRO_EE']	clit=opt
P	['ACRO_EE']	poss=opt
P	['ACRO_EE']	poss=opt
P	['ACRO_EE']	clit=opt
P	['ACRO_EE']	clit=opt
P	['ACRO_EE']	clit=opt
P	['ACRO_EE']	clit=opt
P	['ACRO_EE']	clit=opt
P	['ACRO_EE']	clit=opt
P	['ACRO_EE']	poss=obl
P	['ACRO_EE']	poss=obl
P	['ACRO_EE']	clit=opt
P	['ACRO_EE']	poss=obl
P	['ACRO_EE']	clit=opt
P	['ACRO_EE']	clit=opt
P	['ACRO_EE']	poss=opt
P	['ACRO_EE']	clit=opt
P	['ACRO_EE']	poss=opt
P	['ACRO_EE']	poss=opt
P	['ACRO_EE']	clit=opt
P	['ACRO_EE']	poss=opt
P	['ACRO_EE']	poss=opt
P	['ACRO_EE']	clit=opt
P	['ACRO_EE']	poss=opt
P	['ACRO_EE']	clit=opt
P	['ACRO_EE']	clit=opt
P	['ACRO_EE']	clit=opt
P	['ACRO_EE']	clit=opt
P	['ACRO_EE']	clit=opt
P	['ACRO_EE']	clit=opt
P	['ACRO_EE']	clit=opt
P	['ACRO_EE']	clit=opt
P	['ACRO_EE']	clit=opt
P	['ACRO_EE']	poss=opt
P	['ACRO_EE']	clit=opt
P	['ACRO_EE']	clit=opt
P	['ACRO_EE']	clit=opt
P	['ACRO_EE']	clit=opt
P	['ACRO_EE']	clit=opt
P	['ACRO_EE']	clit=opt
P	['ACRO_EE']	clit=opt
P	['ACRO_EE']	clit=opt
P	['ACRO_EE']	clit=opt
P	['ACRO_EE']	clit=opt
P	['ACRO_EE']	clit=opt
P	['ACRO_EE']	clit=opt
P	['ACRO_EE']	clit=opt
P	['ACRO_EE']	clit=opt
P	['ACRO_EE']	clit=opt
P	['ACRO_EE']	clit=opt
P	['ACRO_EE']	clit=opt
P	['ACRO_EE']	clit=opt
P	['ACRO_EE']	clit=opt
P	['ACRO_EE']	clit=opt
P	['ACRO_EE']	clit=opt
P	['ACRO_EE']	clit=opt
P	['ACRO_EE']	clit=opt
P	['ACRO_EE']	clit=opt
P	['ACRO_EE']	clit=opt
P	['ACRO_EE']	clit=opt
P	['ACRO_EE']	clit=opt
P	['ACRO_EE']	clit=opt
P	['ACRO_EE']	clit=opt
P	['ACRO_EE']	clit=opt
P	['ACRO_EE']	clit=opt
P	['ACRO_EE']	clit=opt
P	['ACRO_EE']	clit=opt
P	['ACRO_EE']	clit=opt
P	['ACRO_EE']	clit=opt
P	['ACRO_EE']	clit=opt
P	['ACRO_EE']	clit=opt
P	['ACRO_EE']	clit=opt
P	['ACRO_EE']	clit=opt
P	['ACRO_EE']	clit=opt
P	['ACRO_EE']	clit=opt
P	['ACRO_EE']	clit=opt
P	['ACRO_EE']	clit=opt
P	['ACRO_EE']	clit=opt
P	['ACRO_EE']	clit=opt
P	['ACRO_EE']	clit=opt
P	['ACRO_EE']	clit=opt
P	['ACRO_EE']	clit=opt
P	['ACRO_EE']	clit=opt
P	['ACRO_EE']	clit=opt
P	['ACRO_EE']	clit=opt
P	['ACRO_EE']	clit=opt
P	['ACRO_EE']	clit=opt
P	['ACRO_EE']	clit=opt
P	['ACRO_EE']	clit=opt
P	['ACRO_EE']	clit=opt
P	['ACRO_EE']	clit=opt
P	['ACRO_EE']	clit=opt
P	['ACRO_EE']	clit=opt
P	['ACRO_EE']	clit=opt
P	['ACRO_EE']	clit=opt
P	['ACRO_EE']	clit=opt
P	['ACRO_EE']	clit=opt
P	['ACRO_EE']	clit=opt
P	['ACRO_EE']	clit=opt
P	['ACRO_EE']	clit=opt
P	['ACRO_EE']	clit=opt
P	['ACRO_EE']	poss=opt
P	['ACRO_EE']	poss=opt
P	['ACRO_EE']	clit=opt
P	['ACRO_EE']	clit=opt
P	['ACRO_EE']	clit=opt
P	['ACRO_EE']	clit=opt
P	['ACRO_EE']	clit=opt
P	['ACRO_EE']	clit=opt
P	['ACRO_EE']	clit=opt
P	['ACRO_EE']	clit=opt
P	['ACRO_EE']	clit=opt
P	['ACRO_EE']	clit=opt
P	['ACRO_EE']	clit=opt
P	['ACRO_EE']	clit=opt
P	['ACRO_EE']	clit=opt
P	['ACRO_EE']	clit=opt
P	['ACRO_EE']	clit=opt
P	['ACRO_EE']	clit=opt
P	['ACRO_EE']	clit=opt
P	['ACRO_EE']	clit=opt
P	['ACRO_EE']	clit=opt
P	['ACRO_EE']	clit=opt
P	['ACRO_EE']	clit=opt
P	['ACRO_EE']	poss=opt
P	['ACRO_EE']	poss=opt
P	['ACRO_EE']	poss=opt
P	['ACRO_EE']	poss=opt
P	['ACRO_EE']	clit=opt
P	['ACRO_EE']	clit=opt
P	['ACRO_EE']	clit=opt
P	['ACRO_EE']	clit=opt
P	['ACRO_EE']	clit=opt
P	['ACRO_EE']	clit=opt
P	['ACRO_EE']	clit=opt
P	['ACRO_EE']	clit=opt
P	['ACRO_EE']	clit=opt
P	['ACRO_EE']	clit=opt
P	['ACRO_EE']	clit=opt
P	['ACRO_EE']	clit=opt
P	['ACRO_EE']	clit=opt
P	['ACRO_EE']	clit=opt
P	['ACRO_EE']	clit=opt
P	['ACRO_EE']	clit=opt
P	['ACRO_EE']	clit=opt
P	['ACRO_EE']	clit=opt
P	['ACRO_EE']	clit=opt
P	['ACRO_EE']	clit=opt
P	['ACRO_EE']	clit=opt
P	['ACRO_EE']	clit=opt
P	['ACRO_EE']	clit=opt
P	['ACRO_EE']	clit=opt
P	['ACRO_EE']	clit=opt
P	['ACRO_EE']	clit=opt
P	['ACRO_EE']	clit=opt
P	['ACRO_EE']	clit=opt
P	['ACRO_EE']	clit=opt
P	['ACRO_EE']	clit=opt
P	['ACRO_EE']	clit=opt
P	['ACRO_EE']	clit=opt
P	['ACRO_EE']	clit=opt
P	['ACRO_EE']	clit=opt
P	['ACRO_EE']	clit=opt
P	['ACRO_EE']	clit=opt
P	['ACRO_EE']	clit=opt
P	['ACRO_EE']	clit=opt
P	['ACRO_EE']	clit=opt
P	['ACRO_EE']	clit=opt
P	['ACRO_EE']	clit=opt
P	['ACRO_EE']	clit=opt
P	['ACRO_EE']	clit=opt
P	['ACRO_EE']	clit=opt
P	['ACRO_EE']	clit=opt
P	['ACRO_EE']	clit=opt
P	['ACRO_EE']	clit=opt
P	['ACRO_EE']	clit=opt
P	['ACRO_EE']	clit=opt
P	['ACRO_EE']	clit=opt
P	['ACRO_EE']	poss=opt
P	['ACRO_EE']	clit=opt
P	['ACRO_EE']	poss=opt
P	['ACRO_EE']	clit=opt
P	['ACRO_EE']	clit=opt
P	['ACRO_EE']	clit=opt
P	['ACRO_EE']	clit=opt
P	['ACRO_EE']	clit=opt
P	['ACRO_EE']	clit=opt
P	['ACRO_EE']	clit=opt
P	['ACRO_EE']	clit=opt
P	['ACRO_EE']	clit=opt
P	['ACRO_EE']	clit=opt
P	['ACRO_EE']	clit=opt
P	['ACRO_EE']	clit=opt
P	['ACRO_EE']	clit=opt
P	['ACRO_EE']	poss=opt
P	['ACRO_EE']	poss=opt
P	['ACRO_EE']	poss=opt
P	['ACRO_EE']	poss=opt
P	['ACRO_EE']	poss=opt
P	['ACRO_EE']	poss=opt
P	['ACRO_EE']	clit=opt
P	['ACRO_EE']	clit=opt
P	['ACRO_EE']	clit=opt
P	['ACRO_EE']	clit=opt
P	['ACRO_EE']	poss=opt
P	['ACRO_EE']	clit=opt
P	['ACRO_EE']	clit=opt
P	['ACRO_EE']	clit=opt
P	['ACRO_EE']	clit=opt
P	['ACRO_EE']	clit=opt
P	['ACRO_EE']	poss=opt
P	['ACRO_EE']	poss=opt
P	['ACRO_EE']	clit=opt
P	['ACRO_EE']	clit=opt
P	['ACRO_EE']	poss=opt
P	['ACRO_EE']	clit=opt
P	['ACRO_EE']	clit=opt
P	['ACRO_EE']	clit=opt
P	['ACRO_EE']	clit=opt
P	['ACRO_EE']	clit=opt
P	['ACRO_EE']	clit=opt
P	['ACRO_EE']	clit=opt
P	['ACRO_EE']	clit=opt
P	['ACRO_EE']	clit=opt
P	['ACRO_EE']	clit=opt
P	['ACRO_EE']	clit=opt
P	['ACRO_EE']	clit=opt
P	['ACRO_EE']	clit=opt
P	['ACRO_EE']	clit=opt
P	['ACRO_EE']	clit=opt
P	['ACRO_EE']	clit=opt
P	['ACRO_EE']	clit=opt
P	['ACRO_EE']	clit=opt
P	['ACRO_EE']	clit=opt
P	['ACRO_EE']	clit=opt
P	['ACRO_EE']	clit=opt
P	['ACRO_EE']	clit=opt
P	['ACRO_EE']	poss=opt
P	['ACRO_EE']	clit=opt
P	['ACRO_EE']	clit=opt
P	['ACRO_EE']	clit=opt
P	['ACRO_EE']	clit=opt
P	['ACRO_EE']	clit=opt
P	['ACRO_EE']	poss=opt
P	['ACRO_EE']	poss=opt
P	['ACRO_EE']	poss=opt
P	['ACRO_EE']	clit=opt
P	['ACRO_EE']	clit=opt
P	['ACRO_EE']	clit=opt
P	['ACRO_EE']	clit=opt
P	['ACRO_EE']	clit=opt
P	['ACRO_EE']	clit=opt
P	['ACRO_EE']	clit=opt
P	['ACRO_EE']	clit=opt
P	['ACRO_EE']	clit=opt
P	['ACRO_EE']	clit=opt
P	['ACRO_EE']	clit=opt
P	['ACRO_EE']	clit=opt
P	['ACRO_EE']	clit=opt
P	['ACRO_EE']	clit=opt
P	['ACRO_EE']	poss=opt
P	['ACRO_EE']	clit=opt
P	['ACRO_EE']	clit=opt
P	['ACRO_EE']	clit=opt
P	['ACRO_EE']	clit=opt
P	['ACRO_EE']	clit=opt
P	['ACRO_EE']	clit=opt
P	['ACRO_EE']	clit=opt
P	['ACRO_EE']	clit=opt
P	['ACRO_EE']	clit=opt
P	['ACRO_EE']	clit=opt
P	['ACRO_EE']	clit=opt
P	['ACRO_EE']	clit=opt
P	['ACRO_EE']	clit=opt
P	['ACRO_EE']	clit=opt
P	['ACRO_EE']	clit=opt
P	['ACRO_EE']	clit=opt
P	['ACRO_EE']	clit=opt
P	['ACRO_EE']	clit=opt
P	['ACRO_EE']	clit=opt
P	['ACRO_EE']	poss=opt
P	['ACRO_EE']	poss=opt
P	['ACRO_EE']	poss=opt
P	['ACRO_EE']	clit=opt
P	['ACRO_EE']	clit=opt
P	['ACRO_EE']	clit=opt
P	['ACRO_EE']	clit=opt
P	['ACRO_EE']	clit=opt
P	['ACRO_EE']	clit=opt
P	['ACRO_EE']	clit=opt
P	['ACRO_EE']	clit=opt
P	['ACRO_EE']	clit=opt
P	['ACRO_EE']	clit=opt
P	['ACRO_EE']	clit=opt
P	['ACRO_EE']	clit=opt
P	['ACRO_EE']	clit=opt
P	['ACRO_EE']	clit=opt
P	['ACRO_EE']	clit=opt
P	['ACRO_EE']	clit=opt
P	['ACRO_EE']	clit=opt
P	['ACRO_EE']	clit=opt
P	['ACRO_EE']	clit=opt
P	['ACRO_EE']	clit=opt
P	['ACRO_EE']	clit=opt
P	['ACRO_EE']	clit=opt
P	['ACRO_EE']	clit=opt
P	['ACRO_EE']	clit=opt
P	['ACRO_EE']	clit=opt
P	['ACRO_EE']	clit=opt
P	['ACRO_EE']	clit=opt
P	['ACRO_EE']	clit=opt
P	['ACRO_EE']	clit=opt
P	['ACRO_EE']	clit=opt
P	['ACRO_EE']	clit=opt
P	['ACRO_EE']	clit=opt
P	['ACRO_EE']	clit=opt
P	['ACRO_EE']	clit=opt
P	['ACRO_EE']	clit=opt
P	['ACRO_EE']	clit=opt
P	['ACRO_EE']	clit=opt
P	['ACRO_EE']	clit=opt
P	['ACRO_EE']	clit=opt
P	['ACRO_EE']	clit=opt
P	['ACRO_EE']	clit=opt
P	['ACRO_EE']	clit=opt
P	['ACRO_EE']	clit=opt
P	['ACRO_EE']	clit=opt
P	['ACRO_EE']	clit=opt
P	['ACRO_EE']	clit=opt
P	['ACRO_EE']	clit=opt
P	['ACRO_EE']	clit=opt
P	['ACRO_EE']	clit=opt
P	['ACRO_EE']	clit=opt
P	['ACRO_EE']	clit=opt
P	['ACRO_EE']	clit=opt
P	['ACRO_EE']	clit=opt
P	['ACRO_EE']	clit=opt
P	['ACRO_EE']	clit=opt
P	['ACRO_EE']	clit=opt
P	['ACRO_EE']	poss=opt
P	['ACRO_EE']	clit=opt
P	['ACRO_EE']	clit=opt
P	['ACRO_EE']	clit=opt
P	['ACRO_EE']	clit=opt
P	['ACRO_EE']	clit=opt
P	['ACRO_EE']	clit=opt
P	['ACRO_EE']	clit=opt
P	['ACRO_EE']	clit=opt
P	['ACRO_EE']	clit=opt
P	['ACRO_EE']	clit=opt
P	['ACRO_EE']	clit=opt
P	['ACRO_EE']	clit=opt
P	['ACRO_EE']	clit=opt
P	['ACRO_EE']	clit=opt
P	['ACRO_EE']	clit=opt
P	['ACRO_EE']	clit=opt
P	['ACRO_EE']	poss=opt
P	['ACRO_EE']	clit=opt
P	['ACRO_EE']	clit=opt
P	['ACRO_EE']	clit=opt
P	['ACRO_EE']	clit=opt
P	['ACRO_EE']	clit=opt
P	['ACRO_EE']	clit=opt
P	['ACRO_EE']	clit=opt
P	['ACRO_EE']	clit=opt
P	['ACRO_EE']	clit=opt
P	['ACRO_EE']	clit=opt
P	['ACRO_EE']	clit=opt
P	['ACRO_EE']	clit=opt
P	['ACRO_EE']	clit=opt
P	['ACRO_EE']	clit=opt
P	['ACRO_EE']	clit=opt
P	['ACRO_EE']	clit=opt
P	['ACRO_EE']	clit=opt
P	['ACRO_EE']	clit=opt
P	['ACRO_EE']	clit=opt
P	['ACRO_EE']	clit=opt
P	['ACRO_EE']	clit=opt
P	['ACRO_EE']	clit=opt
P	['ACRO_EE']	clit=opt
P	['ACRO_EE']	clit=opt
P	['ACRO_EE']	clit=opt
P	['ACRO_EE']	clit=opt
P	['ACRO_EE']	clit=opt
P	['ACRO_EE']	clit=opt
P	['ACRO_EE']	clit=opt
P	['ACRO_EE']	clit=opt
P	['ACRO_EE']	clit=opt
P	['ACRO_EE']	clit=opt
P	['ACRO_EE']	clit=opt
P	['ACRO_EE']	clit=opt
P	['ACRO_EE']	clit=opt
P	['ACRO_EE']	clit=opt
P	['ACRO_EE']	clit=opt
P	['ACRO_EE']	clit=opt
P	['ACRO_EE']	clit=opt
P	['ACRO_EE']	poss=opt
P	['ACRO_EE']	poss=opt
P	['ACRO_EE']	clit=opt
P	['ACRO_EE']	clit=opt
P	['ACRO_EE']	clit=opt
P	['ACRO_EE']	clit=opt
P	['ACRO_EE']	clit=opt
P	['ACRO_EE']	clit=opt
P	['ACRO_EE']	clit=opt
P	['ACRO_EE']	clit=opt
P	['ACRO_EE']	clit=opt
P	['ACRO_EE']	clit=opt
P	['ACRO_EE']	clit=opt
P	['ACRO_EE']	clit=opt
P	['ACRO_EE']	clit=opt
P	['ACRO_EE']	clit=opt
P	['ACRO_EE']	clit=opt
P	['ACRO_EE']	clit=opt
P	['ACRO_EE']	clit=opt
P	['ACRO_EE']	clit=opt
P	['ACRO_EE']	clit=opt
P	['ACRO_EE']	clit=opt
P	['ACRO_EE']	clit=opt
P	['ACRO_EE']	clit=opt
P	['ACRO_EE']	clit=opt
P	['ACRO_EE']	clit=opt
P	['ACRO_EE']	clit=opt
P	['ACRO_EE']	clit=opt
P	['ACRO_EE']	clit=opt
P	['ACRO_EE']	clit=opt
P	['ACRO_EE']	poss=opt
P	['ACRO_EE']	poss=opt
P	['ACRO_EE']	poss=opt
P	['ACRO_EE']	clit=opt
P	['ACRO_EE']	clit=opt
P	['ACRO_EE']	clit=opt
P	['ACRO_EE']	clit=opt
P	['ACRO_EE']	poss=opt
P	['ACRO_EE']	poss=opt
P	['ACRO_EE']	poss=opt
P	['ACRO_EE']	clit=opt
P	['ACRO_EE']	clit=opt
P	['ACRO_EE']	clit=opt
P	['ACRO_EE']	clit=opt
P	['ACRO_EE']	clit=opt
P	['ACRO_EE']	clit=opt
P	['ACRO_EE']	clit=opt
P	['ACRO_EE']	clit=opt
P	['ACRO_EE']	clit=opt
P	['ACRO_EE']	clit=opt
P	['ACRO_EE']	clit=opt
P	['ACRO_EE']	clit=opt
P	['ACRO_EE']	clit=opt
P	['ACRO_EE']	clit=opt
P	['ACRO_EE']	clit=opt
P	['ACRO_EE']	clit=opt
P	['ACRO_EE']	clit=opt
P	['ACRO_EE']	clit=opt
P	['ACRO_EE']	clit=opt
P	['ACRO_EE']	clit=opt
P	['ACRO_EE']	clit=opt
P	['ACRO_EE']	clit=opt
P	['ACRO_EE']	clit=opt
P	['ACRO_EE']	clit=opt
P	['ACRO_EE']	poss=opt
P	['ACRO_EE']	clit=opt
P	['ACRO_EE']	clit=opt
P	['ACRO_EE']	clit=opt
P	['ACRO_EE']	clit=opt
P	['ACRO_EE']	clit=opt
P	['ACRO_EE']	clit=opt
P	['ACRO_EE']	clit=opt
P	['ACRO_EE']	clit=opt
P	['ACRO_EE']	clit=opt
P	['ACRO_EE']	clit=opt
P	['ACRO_EE']	clit=opt
P	['ACRO_EE']	clit=opt
P	['ACRO_EE']	clit=opt
P	['ACRO_EE']	clit=opt
P	['ACRO_EE']	clit=opt
P	['ACRO_EE']	clit=opt
P	['ACRO_EE']	clit=opt
P	['ACRO_EE']	clit=opt
P	['ACRO_EE']	clit=opt
P	['ACRO_EE']	clit=opt
P	['ACRO_EE']	clit=opt
P	['ACRO_EE']	clit=opt
P	['ACRO_EE']	clit=opt
P	['ACRO_EE']	clit=opt
P	['ACRO_EE']	clit=opt
P	['ACRO_EE']	clit=opt
P	['ACRO_EE']	clit=opt
P	['ACRO_EE']	clit=opt
P	['ACRO_EE']	clit=opt
P	['ACRO_EE']	clit=opt
P	['ACRO_EE']	clit=opt
P	['ACRO_EE']	poss=opt
P	['ACRO_EE']	poss=opt
P	['ACRO_EE']	poss=opt
P	['ACRO_EE']	poss=opt
P	['ACRO_EE']	poss=opt
P	['ACRO_EE']	poss=opt
P	['ACRO_EE']	clit=opt
P	['ACRO_EE']	clit=opt
P	['ACRO_EE']	clit=opt
P	['ACRO_EE']	clit=opt
P	['ACRO_EE']	clit=opt
P	['ACRO_EE']	clit=opt
P	['ACRO_EE']	clit=opt
P	['ACRO_EE']	clit=opt
P	['ACRO_EE']	clit=opt
P	['ACRO_EE']	clit=opt
P	['ACRO_EE']	clit=opt
P	['ACRO_EE']	clit=opt
P	['ACRO_EE']	clit=opt
P	['ACRO_EE']	clit=opt
P	['ACRO_EE']	clit=opt
P	['ACRO_EE']	clit=opt
P	['ACRO_EE']	clit=opt
P	['ACRO_EE']	clit=opt
P	['ACRO_EE']	clit=opt
P	['ACRO_EE']	clit=opt
P	['ACRO_EE']	clit=opt
P	['ACRO_EE']	clit=opt
P	['ACRO_EE']	clit=opt
P	['ACRO_EE']	clit=opt
P	['ACRO_EE']	clit=opt
P	['ACRO_EE']	poss=opt
P	['ACRO_EE']	poss=opt
P	['ACRO_EE']	clit=opt
P	['ACRO_EE']	clit=opt
P	['ACRO_EE']	clit=opt
P	['ACRO_EE']	clit=opt
P	['ACRO_EE']	clit=opt
P	['ACRO_EE']	clit=opt
P	['ACRO_EE']	clit=opt
P	['ACRO_EE']	clit=opt
P	['ACRO_EE']	clit=opt
P	['ACRO_EE']	clit=opt
P	['ACRO_EE']	clit=opt
P	['ACRO_EE']	clit=opt
P	['ACRO_EE']	clit=opt
P	['ACRO_EE']	clit=opt
P	['ACRO_EE']	clit=opt
P	['ACRO_EE']	clit=opt
P	['ACRO_EE']	clit=opt
P	['ACRO_EE']	clit=opt
P	['ACRO_EE']	clit=opt
P	['ACRO_EE']	clit=opt
P	['ACRO_EE']	clit=opt
P	['ACRO_EE']	clit=opt
P	['ACRO_EE']	clit=opt
P	['ACRO_EE']	clit=opt
P	['ACRO_EE']	clit=opt
P	['ACRO_EE']	clit=opt
P	['ACRO_EE']	clit=opt
P	['ACRO_EE']	clit=opt
P	['ACRO_EE']	clit=opt
P	['ACRO_EE']	clit=opt
P	['ACRO_EE']	clit=opt
P	['ACRO_EE']	clit=opt
P	['ACRO_EE']	clit=opt
P	['ACRO_EE']	clit=opt
P	['ACRO_EE']	clit=opt
P	['ACRO_EE']	clit=opt
P	['ACRO_EE']	clit=opt
P	['ACRO_EE']	clit=opt
P	['ACRO_EE']	clit=opt
P	['ACRO_EE']	clit=opt
P	['ACRO_EE']	clit=opt
P	['ACRO_EE']	poss=opt
P	['ACRO_EE']	poss=opt
P	['ACRO_EE']	clit=opt
P	['ACRO_EE']	poss=opt
P	['ACRO_EE']	poss=opt
P	['ACRO_EE']	clit=opt
P	['ACRO_EE']	clit=opt
P	['ACRO_EE']	clit=opt
P	['ACRO_EE']	clit=opt
P	['ACRO_EE']	clit=opt
P	['ACRO_EE']	clit=opt
P	['ACRO_EE']	clit=opt
P	['ACRO_EE']	poss=opt
P	['ACRO_EE']	clit=opt
P	['ACRO_EE']	poss=opt
P	['ACRO_EE']	clit=opt
P	['ACRO_EE']	clit=opt
P	['ACRO_EE']	clit=opt
P	['ACRO_EE']	clit=opt
P	['ACRO_EE']	clit=opt
P	['ACRO_EE']	clit=opt
P	['ACRO_EE']	poss=opt
P	['ACRO_EE']	poss=opt
P	['ACRO_EE']	clit=opt
P	['ACRO_EE']	clit=opt
P	['ACRO_EE']	clit=opt
P	['ACRO_EE']	clit=opt
P	['ACRO_EE']	clit=opt
P	['ACRO_EE']	clit=opt
P	['ACRO_EE']	clit=opt
P	['ACRO_EE']	clit=opt
P	['ACRO_EE']	clit=opt
P	['ACRO_EE']	poss=opt
P	['ACRO_EE']	clit=opt
P	['ACRO_EE']	clit=opt
P	['ACRO_EE']	poss=opt
P	['ACRO_EE']	poss=opt
P	['ACRO_EE']	clit=opt
P	['ACRO_EE']	clit=opt
P	['ACRO_EE']	clit=opt
P	['ACRO_EE']	clit=opt
P	['ACRO_EE']	clit=opt
P	['ACRO_EE']	clit=opt
P	['ACRO_EE']	poss=opt
P	['ACRO_EE']	poss=opt
P	['ACRO_EE']	clit=opt
P	['ACRO_EE']	clit=opt
P	['ACRO_EE']	clit=opt
P	['ACRO_EE']	clit=opt
P	['ACRO_EE']	poss=opt
P	['ACRO_EE']	clit=opt
P	['ACRO_EE']	clit=opt
P	['ACRO_EE']	clit=opt
P	['ACRO_EE']	clit=opt
P	['ACRO_EE']	clit=opt
P	['ACRO_EE']	clit=opt
P	['ACRO_EE']	clit=opt
P	['ACRO_EE']	clit=opt
P	['ACRO_EE']	poss=opt
P	['ACRO_EE']	clit=opt
P	['ACRO_EE']	clit=opt
P	['ACRO_EE']	clit=opt
P	['ACRO_EE']	clit=opt
P	['ACRO_EE']	clit=opt
P	['ACRO_EE']	clit=opt
P	['ACRO_EE']	clit=opt
P	['ACRO_EE']	clit=opt
P	['ACRO_EE']	clit=opt
P	['ACRO_EE']	clit=opt
P	['ACRO_EE']	clit=opt
P	['ACRO_EE']	clit=opt
P	['ACRO_EE']	clit=opt
P	['ACRO_EE']	clit=opt
P	['ACRO_EE']	clit=opt
P	['ACRO_EE']	clit=opt
P	['ACRO_EE']	clit=opt
P	['ACRO_EE']	clit=opt
P	['ACRO_EE']	clit=opt
P	['ACRO_EE']	clit=opt
P	['ACRO_EE']	clit=opt
P	['ACRO_EE']	clit=opt
P	['ACRO_EE']	clit=opt
P	['ACRO_EE']	clit=opt
P	['ACRO_EE']	clit=opt
P	['ACRO_EE']	clit=opt
P	['ACRO_EE']	clit=opt
P	['ACRO_EE']	clit=opt
P	['ACRO_EE']	clit=opt
P	['ACRO_EE']	clit=opt
P	['ACRO_EE']	clit=opt
P	['ACRO_EE']	clit=opt
P	['ACRO_EE']	clit=opt
P	['ACRO_EE']	clit=opt
P	['ACRO_EE']	clit=opt
P	['ACRO_EE']	clit=opt
P	['ACRO_EE']	clit=opt
P	['ACRO_EE']	clit=opt
P	['ACRO_EE']	clit=opt
P	['ACRO_EE']	clit=opt
P	['ACRO_EE']	clit=opt
P	['ACRO_EE']	clit=opt
P	['ACRO_EE']	poss=opt
P	['ACRO_EE']	poss=opt
P	['ACRO_EE']	poss=opt
P	['ACRO_EE']	poss=opt
P	['ACRO_EE']	poss=opt
P	['ACRO_EE']	poss=opt
P	['ACRO_EE']	clit=opt
P	['ACRO_EE']	poss=opt
P	['ACRO_EE']	clit=opt
P	['ACRO_EE']	clit=opt
P	['ACRO_EE']	clit=opt
P	['ACRO_EE']	clit=opt
P	['ACRO_EE']	clit=opt
P	['ACRO_EE']	clit=opt
P	['ACRO_EE']	clit=opt
P	['ACRO_EE']	poss=opt
P	['ACRO_EE']	clit=opt
P	['ACRO_EE']	clit=opt
P	['ACRO_EE']	clit=opt
P	['ACRO_EE']	clit=opt
P	['ACRO_EE']	clit=opt
P	['ACRO_EE']	clit=opt
P	['ACRO_EE']	clit=opt
P	['ACRO_EE']	clit=opt
P	['ACRO_EE']	clit=opt
P	['ACRO_EE']	clit=opt
P	['ACRO_EE']	clit=opt
P	['ACRO_EE']	clit=opt
P	['ACRO_EE']	clit=opt
P	['ACRO_EE']	clit=opt
P	['ACRO_EE']	clit=opt
P	['ACRO_EE']	clit=opt
P	['ACRO_EE']	clit=opt
P	['ACRO_EE']	clit=opt
P	['ACRO_EE']	clit=opt
P	['ACRO_EE']	clit=opt
P	['ACRO_EE']	poss=opt
P	['ACRO_EE']	clit=opt
P	['ACRO_EE']	clit=opt
P	['ACRO_EE']	clit=opt
P	['ACRO_EE']	clit=opt
P	['ACRO_EE']	clit=opt
P	['ACRO_EE']	clit=opt
P	['ACRO_EE']	clit=opt
P	['ACRO_EE']	clit=opt
P	['ACRO_EE']	clit=opt
P	['ACRO_EE']	clit=opt
P	['ACRO_EE']	clit=opt
P	['ACRO_EE']	clit=opt
P	['ACRO_EE']	clit=opt
P	['ACRO_EE']	clit=opt
P	['ACRO_EE']	clit=opt
P	['ACRO_EE']	clit=opt
P	['ACRO_EE']	clit=opt
P	['ACRO_EE']	clit=opt
P	['ACRO_EE']	clit=opt
P	['ACRO_EE']	clit=opt
P	['ACRO_EE']	clit=opt
P	['ACRO_EE']	clit=opt
P	['ACRO_EE']	clit=opt
P	['ACRO_EE']	clit=opt
P	['ACRO_EE']	clit=opt
P	['ACRO_EE']	clit=opt
P	['ACRO_EE']	clit=opt
P	['ACRO_EE']	clit=opt
P	['ACRO_EE']	clit=opt
P	['ACRO_EE']	clit=opt
P	['ACRO_EE']	clit=opt
P	['ACRO_EE']	clit=opt
P	['ACRO_EE']	clit=opt
P	['ACRO_EE']	clit=opt
P	['ACRO_EE']	poss=opt
P	['ACRO_EE']	poss=opt
P	['ACRO_EE']	clit=opt
P	['ACRO_EE']	clit=opt
P	['ACRO_EE']	clit=opt
P	['ACRO_EE']	clit=opt
P	['ACRO_EE']	clit=opt
P	['ACRO_EE']	clit=opt
P	['ACRO_EE']	clit=opt
P	['ACRO_EE']	clit=opt
P	['ACRO_EE']	poss=opt
P	['ACRO_EE']	clit=opt
P	['ACRO_EE']	clit=opt
P	['ACRO_EE']	clit=opt
P	['ACRO_EE']	clit=opt
P	['ACRO_EE']	clit=opt
P	['ACRO_EE']	clit=opt
P	['ACRO_EE']	clit=opt
P	['ACRO_EE']	clit=opt
P	['ACRO_EE']	clit=opt
P	['ACRO_EE']	clit=opt
P	['ACRO_EE']	clit=opt
P	['ACRO_EE']	clit=opt
P	['ACRO_EE']	clit=opt
P	['ACRO_EE']	clit=opt
P	['ACRO_EE']	clit=opt
P	['ACRO_EE']	clit=opt
P	['ACRO_EE']	clit=opt
P	['ACRO_EE']	clit=opt
P	['ACRO_EE']	clit=opt
P	['ACRO_EE']	clit=opt
P	['ACRO_EE']	poss=opt
P	['ACRO_EE']	clit=opt
P	['ACRO_EE']	clit=opt
P	['ACRO_EE']	poss=opt
P	['ACRO_EE']	poss=opt
P	['ACRO_EE']	poss=opt
P	['ACRO_EE']	clit=opt
P	['ACRO_EE']	clit=opt
P	['ACRO_EE']	clit=opt
P	['ACRO_EE']	clit=opt
P	['ACRO_EE']	clit=opt
P	['ACRO_EE']	clit=opt
P	['ACRO_EE']	clit=opt
P	['ACRO_EE']	clit=opt
P	['ACRO_EE']	poss=opt
P	['ACRO_EE']	poss=opt
P	['ACRO_EE']	clit=opt
P	['ACRO_EE']	clit=opt
P	['ACRO_EE']	clit=opt
P	['ACRO_EE']	clit=opt
P	['ACRO_EE']	clit=opt
P	['ACRO_EE']	clit=opt
P	['ACRO_EE']	clit=opt
P	['ACRO_EE']	clit=opt
P	['ACRO_EE']	clit=opt
P	['ACRO_EE']	clit=opt
P	['ACRO_EE']	clit=opt
P	['ACRO_EE']	clit=opt
P	['ACRO_EE']	clit=opt
P	['ACRO_EE']	clit=opt
P	['ACRO_EE']	clit=opt
P	['ACRO_EE']	clit=opt
P	['ACRO_EE']	clit=opt
P	['ACRO_EE']	clit=opt
P	['ACRO_EE']	clit=opt
P	['ACRO_EE']	clit=opt
P	['ACRO_EE']	clit=opt
P	['ACRO_EE']	clit=opt
P	['ACRO_EE']	clit=opt
P	['ACRO_EE']	clit=opt
P	['ACRO_EE']	clit=opt
P	['ACRO_EE']	clit=opt
P	['ACRO_EE']	clit=opt
P	['ACRO_EE']	clit=opt
P	['ACRO_EE']	clit=opt
P	['ACRO_EE']	clit=opt
P	['ACRO_EE']	clit=opt
P	['ACRO_EE']	clit=opt
P	['ACRO_EE']	clit=opt
P	['ACRO_EE']	clit=opt
P	['ACRO_EE']	clit=opt
P	['ACRO_EE']	clit=opt
P	['ACRO_EE']	clit=opt
P	['ACRO_EE']	clit=opt
P	['ACRO_EE']	clit=opt
P	['ACRO_EE']	clit=opt
P	['ACRO_EE']	clit=opt
P	['ACRO_EE']	clit=opt
P	['ACRO_EE']	clit=opt
P	['ACRO_EE']	clit=opt
P	['ACRO_EE']	clit=opt
P	['ACRO_EE']	clit=opt
P	['ACRO_EE']	clit=opt
P	['ACRO_EE']	clit=opt
P	['ACRO_EE']	clit=opt
P	['ACRO_EE']	clit=opt
P	['ACRO_EE']	poss=opt
P	['ACRO_EE']	poss=opt
P	['ACRO_EE']	poss=opt
P	['ACRO_EE']	clit=opt
P	['ACRO_EE']	clit=opt
P	['ACRO_EE']	clit=opt
P	['ACRO_EE']	clit=opt
P	['ACRO_EE']	clit=opt
P	['ACRO_EE']	clit=opt
P	['ACRO_EE']	clit=opt
P	['ACRO_EE']	clit=opt
P	['ACRO_EE']	clit=opt
P	['ACRO_EE']	clit=opt
P	['ACRO_EE']	clit=opt
P	['ACRO_EE']	poss=opt
P	['ACRO_EE']	clit=opt
P	['ACRO_EE']	poss=opt
P	['ACRO_EE']	poss=opt
P	['ACRO_EE']	clit=opt
P	['ACRO_EE']	clit=opt
P	['ACRO_EE']	clit=opt
P	['ACRO_EE']	clit=opt
P	['ACRO_EE']	poss=opt
P	['ACRO_EE']	clit=opt
P	['ACRO_EE']	clit=opt
P	['ACRO_EE']	clit=opt
P	['ACRO_EE']	poss=opt
P	['ACRO_EE']	poss=opt
P	['ACRO_EE']	clit=opt
P	['ACRO_EE']	clit=opt
P	['ACRO_EE']	clit=opt
P	['ACRO_EE']	clit=opt
P	['ACRO_EE']	poss=opt
P	['ACRO_EE']	poss=opt
P	['ACRO_EE']	poss=opt
P	['ACRO_EE']	clit=opt
P	['ACRO_EE']	clit=opt
P	['ACRO_EE']	clit=opt
P	['ACRO_EE']	clit=opt
P	['ACRO_EE']	clit=opt
P	['ACRO_EE']	clit=opt
P	['ACRO_EE']	clit=opt
P	['ACRO_EE']	clit=opt
P	['ACRO_EE']	clit=opt
P	['ACRO_EE']	clit=opt
P	['ACRO_EE']	clit=opt
P	['ACRO_EE']	poss=opt
P	['ACRO_EE']	clit=opt
P	['ACRO_EE']	clit=opt
P	['ACRO_EE']	clit=opt
P	['ACRO_EE']	clit=opt
P	['ACRO_EE']	poss=opt
P	['ACRO_EE']	clit=opt
P	['ACRO_EE']	clit=opt
P	['ACRO_EE']	clit=opt
P	['ACRO_EE']	clit=opt
P	['ACRO_EE']	clit=opt
P	['ACRO_EE']	clit=opt
P	['ACRO_EE']	clit=opt
P	['ACRO_EE']	clit=opt
P	['ACRO_EE']	clit=opt
P	['ACRO_EE']	clit=opt
P	['ACRO_EE']	clit=opt
P	['ACRO_EE']	poss=opt
P	['ACRO_EE']	clit=opt
P	['ACRO_EE']	clit=opt
P	['ACRO_EE']	clit=opt
P	['ACRO_EE']	clit=opt
P	['ACRO_EE']	poss=opt
P	['ACRO_EE']	poss=opt
P	['ACRO_EE']	clit=opt
P	['ACRO_EE']	clit=opt
P	['ACRO_EE']	clit=opt
pahanilkisesti	['PCLE_TYHMÄSTI']	clit=opt
pahankurisesti	['PCLE_NOPEASTI']	clit=opt
pahanlaisesti	['PCLE_NOPEASTI']	clit=opt
pahanpäiväisesti	['PCLE_TYHMÄSTI']	clit=opt
pahansuovasti	['PCLE_NOPEASTI']	clit=opt
pahantuulisesti	['PCLE_NOPEASTI']	clit=opt
pahasti	['PCLE_NOPEASTI']	clit=opt
paheellisesti	['PCLE_NOPEASTI']	clit=opt
pahimmoiksi	['PCLE_VUOKSI']	poss=opt
pahuksesti	['PCLE_NOPEASTI']	clit=opt
paikalla	['PCLE_KOTONA']	poss=opt
paikalle	['PCLE_ALLE']	poss=obl
paikallisesti	['PCLE_NOPEASTI']	clit=opt
paikalta	['PCLE_KOTONA']	poss=opt
paikkakunnittain	['PCLE_VALTAAN']	clit=opt
paikoittain	['PCLE_VALTAAN']	clit=opt
painavasti	['PCLE_NOPEASTI']	clit=opt
-painoisesti	['PCLE_NOPEASTI']	clit=opt
painokkaasti	['PCLE_NOPEASTI']	clit=opt
-painotteisesti	['PCLE_NOPEASTI']	clit=opt
paitsi	['PCLE_VUOKSI']	clit=opt
pakahduksiin	['PCLE_VALTAAN']	poss=opt
pakahduksissa	['PCLE_KOTONA']	poss=opt
pakanasti	['PCLE_NOPEASTI']	clit=opt
pakottomasti	['PCLE_NOPEASTI']	clit=opt
paksusti	['PCLE_NOPEASTI']	clit=opt
palelluksissa	['PCLE_KOTONA']	poss=opt
palkattomasti	['PCLE_NOPEASTI']	clit=opt
paloittain	['PCLE_VALTAAN']	clit=opt
palstoittain	['PCLE_VALTAAN']	clit=opt
palvovasti	['PCLE_NOPEASTI']	clit=opt
papillisesti	['PCLE_NOPEASTI']	clit=opt
paradoksaalisesti	['PCLE_NOPEASTI']	clit=opt
parantumattomasti	['PCLE_NOPEASTI']	clit=opt
pareittain	['PCLE_VALTAAN']	clit=opt
pariin	['PCLE_VALTAAN']	poss=opt
parissa	['PCLE_KOTONA']	poss=opt
parista	['PCLE_KOTONA']	poss=opt
parittain	['PCLE_VALTAAN']	clit=opt
parlamentaarisesti	['PCLE_NOPEASTI']	clit=opt
parodisesti	['PCLE_NOPEASTI']	clit=opt
parvittain	['PCLE_VALTAAN']	clit=opt
pasifistisesti	['PCLE_NOPEASTI']	clit=opt
passiivisesti	['PCLE_NOPEASTI']	clit=opt
pateettisesti	['PCLE_NOPEASTI']	clit=opt
pedagogisesti	['PCLE_NOPEASTI']	clit=opt
pedanttisesti	['PCLE_NOPEASTI']	clit=opt
peevelisti	['PCLE_TYHMÄSTI']	clit=opt
pehmeästi	['PCLE_TYHMÄSTI']	clit=opt
peijakkaasti	['PCLE_NOPEASTI']	clit=opt
peitellysti	['PCLE_TYHMÄSTI']	clit=opt
peitetysti	['PCLE_TYHMÄSTI']	clit=opt
pelkurimaisesti	['PCLE_NOPEASTI']	clit=opt
pelkästään	['PCLE_NÄKYVIIN']	clit=opt
pelokkaasti	['PCLE_NOPEASTI']	clit=opt
pelottavasti	['PCLE_NOPEASTI']	clit=opt
pelottomasti	['PCLE_NOPEASTI']	clit=opt
penikkamaisesti	['PCLE_NOPEASTI']	clit=opt
pensasmaisesti	['PCLE_NOPEASTI']	clit=opt
penseästi	['PCLE_TYHMÄSTI']	clit=opt
penteleesti	['PCLE_TYHMÄSTI']	clit=opt
pentumaisesti	['PCLE_NOPEASTI']	clit=opt
perhanasti	['PCLE_NOPEASTI']	clit=opt
perheittäin	['PCLE_NÄKYVIIN']	clit=opt
perimmältä	['PCLE_IKINÄ']	poss=opt
perinnäisesti	['PCLE_TYHMÄSTI']	clit=opt
perinpohjaisesti	['PCLE_NOPEASTI']	clit=opt
perinteellisesti	['PCLE_TYHMÄSTI']	clit=opt
perinteisesti	['PCLE_TYHMÄSTI']	clit=opt
periodeittain	['PCLE_VALTAAN']	clit=opt
periodisesti	['PCLE_NOPEASTI']	clit=opt
perkeleesti	['PCLE_TYHMÄSTI']	clit=opt
persoonallisesti	['PCLE_NOPEASTI']	clit=opt
persoonattomasti	['PCLE_NOPEASTI']	clit=opt
perusteella	['PCLE_KOTONA']	clit=opt
perusteellisesti	['PCLE_NOPEASTI']	clit=opt
perusteettomasti	['PCLE_NOPEASTI']	clit=opt
perustuen	['PCLE_VALTAAN']	clit=opt
perustuslaillisesti	['PCLE_NOPEASTI']	clit=opt
peruuttamattomasti	['PCLE_NOPEASTI']	clit=opt
peräkkäisesti	['PCLE_TYHMÄSTI']	clit=opt
perältä	['PCLE_IKINÄ']	poss=obl
perässä	['PCLE_IKINÄ']	poss=opt
perästä	['PCLE_IKINÄ']	poss=opt
perättäin	['PCLE_NÄKYVIIN']	clit=opt
perättäisesti	['PCLE_TYHMÄSTI']	clit=opt
perättömästi	['PCLE_TYHMÄSTI']	clit=opt
peräänantamattomasti	['PCLE_NOPEASTI']	clit=opt
perään	['PCLE_NÄKYVIIN']	poss=opt
pessimistisesti	['PCLE_TYHMÄSTI']	clit=opt
petoksellisesti	['PCLE_NOPEASTI']	clit=opt
petollisesti	['PCLE_NOPEASTI']	clit=opt
petomaisesti	['PCLE_NOPEASTI']	clit=opt
pettämättömästi	['PCLE_TYHMÄSTI']	clit=opt
pidäkkeettömästi	['PCLE_TYHMÄSTI']	clit=opt
pidättyväisesti	['PCLE_TYHMÄSTI']	clit=opt
pidättyvästi	['PCLE_TYHMÄSTI']	clit=opt
pieteettisesti	['PCLE_TYHMÄSTI']	clit=opt
piikikkäästi	['PCLE_TYHMÄSTI']	clit=opt
piilotajuisesti	['PCLE_NOPEASTI']	clit=opt
piinallisesti	['PCLE_NOPEASTI']	clit=opt
piireittäin	['PCLE_NÄKYVIIN']	clit=opt
piittaamattomasti	['PCLE_NOPEASTI']	clit=opt
pikaisesti	['PCLE_NOPEASTI']	clit=opt
pikaistuksissa	['PCLE_KOTONA']	poss=opt
pikantisti	['PCLE_NOPEASTI']	clit=opt
pikimmältä	['PCLE_IKINÄ']	poss=opt
pikkumaisesti	['PCLE_NOPEASTI']	clit=opt
pikkutarkasti	['PCLE_NOPEASTI']	clit=opt
pikkuvanhasti	['PCLE_NOPEASTI']	clit=opt
pilkallisesti	['PCLE_NOPEASTI']	clit=opt
piloilla	['PCLE_KOTONA']	poss=obl
pimeästi	['PCLE_TYHMÄSTI']	clit=opt
pinkoittain	['PCLE_VALTAAN']	clit=opt
pinnalla	['PCLE_KOTONA']	poss=opt
pinnalle	['PCLE_ALLE']	poss=opt
pinnallisesti	['PCLE_NOPEASTI']	clit=opt
pinnalta	['PCLE_KOTONA']	poss=opt
pinnassa	['PCLE_KOTONA']	poss=opt
pinnasta	['PCLE_KOTONA']	poss=opt
pintapuolisesti	['PCLE_NOPEASTI']	clit=opt
pirullisesti	['PCLE_NOPEASTI']	clit=opt
pirusti	['PCLE_NOPEASTI']	clit=opt
pisteliäästi	['PCLE_TYHMÄSTI']	clit=opt
pitkittäin	['PCLE_NÄKYVIIN']	clit=opt
pitkäjännitteisesti	['PCLE_TYHMÄSTI']	clit=opt
pitkäjänteisesti	['PCLE_TYHMÄSTI']	clit=opt
pitkälle	['PCLE_YLLE']	poss=opt
pitkällä	['PCLE_IKINÄ']	poss=obl
pitkämielisesti	['PCLE_TYHMÄSTI']	clit=opt
pitkäpiimäisesti	['PCLE_TYHMÄSTI']	clit=opt
pitkästi	['PCLE_TYHMÄSTI']	clit=opt
pitkästyttävästi	['PCLE_TYHMÄSTI']	clit=opt
pitkäveteisesti	['PCLE_TYHMÄSTI']	clit=opt
piukasti	['PCLE_NOPEASTI']	clit=opt
plastisesti	['PCLE_NOPEASTI']	clit=opt
pneumaattisesti	['PCLE_NOPEASTI']	clit=opt
-pohjaisesti	['PCLE_NOPEASTI']	clit=opt
pohjalaisittain	['PCLE_VALTAAN']	clit=opt
pohjalla	['PCLE_KOTONA']	poss=opt
pohjalle	['PCLE_ALLE']	poss=opt
pohjalta	['PCLE_KOTONA']	poss=opt
pohjassa	['PCLE_KOTONA']	poss=opt
pohjasta	['PCLE_KOTONA']	poss=opt
pohjattomasti	['PCLE_NOPEASTI']	clit=opt
pohjimmalta	['PCLE_KOTONA']	poss=opt
poikamaisesti	['PCLE_NOPEASTI']	clit=opt
poikittain	['PCLE_VALTAAN']	clit=opt
poikkeavasti	['PCLE_NOPEASTI']	clit=opt
poikkeuksellisesti	['PCLE_NOPEASTI']	clit=opt
poleemisesti	['PCLE_NOPEASTI']	clit=opt
poliittisesti	['PCLE_NOPEASTI']	clit=opt
polikliinisesti	['PCLE_TYHMÄSTI']	clit=opt
poljennollisesti	['PCLE_NOPEASTI']	clit=opt
pomminvarmasti	['PCLE_NOPEASTI']	clit=opt
ponnekkaasti	['PCLE_NOPEASTI']	clit=opt
pontevasti	['PCLE_NOPEASTI']	clit=opt
porrasteisesti	['PCLE_NOPEASTI']	clit=opt
porsasmaisesti	['PCLE_NOPEASTI']	clit=opt
portaattomasti	['PCLE_NOPEASTI']	clit=opt
portaittain	['PCLE_VALTAAN']	clit=opt
porvarillisesti	['PCLE_NOPEASTI']	clit=opt
positiivisesti	['PCLE_NOPEASTI']	clit=opt
poskettomasti	['PCLE_NOPEASTI']	clit=opt
potentiaalisesti	['PCLE_NOPEASTI']	clit=opt
pottumaisesti	['PCLE_NOPEASTI']	clit=opt
pragmaattisesti	['PCLE_NOPEASTI']	clit=opt
prameasti	['PCLE_NOPEASTI']	clit=opt
primaarisesti	['PCLE_NOPEASTI']	clit=opt
primaaristi	['PCLE_NOPEASTI']	clit=opt
primitiivisesti	['PCLE_TYHMÄSTI']	clit=opt
privaatisti	['PCLE_NOPEASTI']	clit=opt
problemaattisesti	['PCLE_NOPEASTI']	clit=opt
profeetallisesti	['PCLE_NOPEASTI']	clit=opt
profylaktisesti	['PCLE_NOPEASTI']	clit=opt
progressiivisesti	['PCLE_NOPEASTI']	clit=opt
proosallisesti	['PCLE_NOPEASTI']	clit=opt
prosenttisesti	['PCLE_NOPEASTI']	clit=opt
prosentuaalisesti	['PCLE_NOPEASTI']	clit=opt
provokatiivisesti	['PCLE_NOPEASTI']	clit=opt
provokatorisesti	['PCLE_NOPEASTI']	clit=opt
psykologisesti	['PCLE_NOPEASTI']	clit=opt
psykoottisesti	['PCLE_NOPEASTI']	clit=opt
psyykkisesti	['PCLE_TYHMÄSTI']	clit=opt
puhtaasti	['PCLE_NOPEASTI']	clit=opt
puisevasti	['PCLE_NOPEASTI']	clit=opt
puitteissa	['PCLE_KOTONA']	clit=opt
puitteissa	['PCLE_KOTONA']	poss=opt
pulloittain	['PCLE_VALTAAN']	clit=opt
pulskasti	['PCLE_NOPEASTI']	clit=opt
puoleen	['PCLE_VALTAAN']	poss=opt
puoleensavetävästi	['PCLE_TYHMÄSTI']	clit=opt
-puoleisesti	['PCLE_NOPEASTI']	clit=opt
puolessa	['PCLE_KOTONA']	poss=opt
puolesta	['PCLE_KOTONA']	poss=opt
puoliautomaattisesti	['PCLE_NOPEASTI']	clit=opt
puolihuolimattomasti	['PCLE_NOPEASTI']	clit=opt
puolikuukausittain	['PCLE_VALTAAN']	clit=opt
puolinaisesti	['PCLE_NOPEASTI']	clit=opt
puolittain	['PCLE_VALTAAN']	clit=opt
puolitunneittain	['PCLE_VALTAAN']	clit=opt
puolivillaisesti	['PCLE_NOPEASTI']	clit=opt
puolivirallisesti	['PCLE_NOPEASTI']	clit=opt
puolivuosittain	['PCLE_VALTAAN']	clit=opt
puolueellisesti	['PCLE_NOPEASTI']	clit=opt
puolueettomasti	['PCLE_NOPEASTI']	clit=opt
puolueittain	['PCLE_VALTAAN']	clit=opt
puolustuksellisesti	['PCLE_NOPEASTI']	clit=opt
purevasti	['PCLE_NOPEASTI']	clit=opt
puristeisesti	['PCLE_NOPEASTI']	clit=opt
puristisesti	['PCLE_NOPEASTI']	clit=opt
puritaanisesti	['PCLE_NOPEASTI']	clit=opt
pusseittain	['PCLE_VALTAAN']	clit=opt
puuhakkaasti	['PCLE_NOPEASTI']	clit=opt
puuskittain	['PCLE_VALTAAN']	clit=opt
puuskittaisesti	['PCLE_NOPEASTI']	clit=opt
puutteellisesti	['PCLE_NOPEASTI']	clit=opt
pyhästi	['PCLE_TYHMÄSTI']	clit=opt
pykälittäin	['PCLE_NÄKYVIIN']	clit=opt
pystysuorasti	['PCLE_NOPEASTI']	clit=opt
pysyväisesti	['PCLE_TYHMÄSTI']	clit=opt
pyyteettömästi	['PCLE_TYHMÄSTI']	clit=opt
pyöreästi	['PCLE_TYHMÄSTI']	clit=opt
päin	['PCLE_NÄKYVIIN']	clit=opt
päittäin	['PCLE_NÄKYVIIN']	clit=opt
päivittäin	['PCLE_NÄKYVIIN']	clit=opt
päiväkirurgisesti	['PCLE_NOPEASTI']	clit=opt
päivänselvästi	['PCLE_TYHMÄSTI']	clit=opt
pälvittäin	['PCLE_NÄKYVIIN']	clit=opt
pätkittäin	['PCLE_NÄKYVIIN']	clit=opt
pääasiallisesti	['PCLE_NOPEASTI']	clit=opt
päädyittäin	['PCLE_NÄKYVIIN']	clit=opt
pääkaupunkilaisittain	['PCLE_VALTAAN']	clit=opt
pääkohdittain	['PCLE_VALTAAN']	clit=opt
päälle	['PCLE_YLLE']	poss=opt
päällettäin	['PCLE_NÄKYVIIN']	clit=opt
päällitse	['PCLE_YLLE']	poss=opt
päällä	['PCLE_IKINÄ']	poss=opt
päältä	['PCLE_IKINÄ']	poss=opt
päämäärättömästi	['PCLE_TYHMÄSTI']	clit=opt
pääpiirteisesti	['PCLE_TYHMÄSTI']	clit=opt
pääpiirteittäin	['PCLE_NÄKYVIIN']	clit=opt
pääsääntöisesti	['PCLE_TYHMÄSTI']	clit=opt
päättäväisesti	['PCLE_TYHMÄSTI']	clit=opt
päättävästi	['PCLE_TYHMÄSTI']	clit=opt
päättömästi	['PCLE_TYHMÄSTI']	clit=opt
pökerryksiin	['PCLE_NÄKYVIIN']	poss=opt
pökerryksissä	['PCLE_IKINÄ']	poss=opt
pökerryksistä	['PCLE_IKINÄ']	poss=opt
pöllösti	['PCLE_TYHMÄSTI']	clit=opt
pörhölle	['PCLE_YLLE']	poss=opt
pörhöllä	['PCLE_IKINÄ']	poss=opt
pörrölle	['PCLE_YLLE']	poss=opt
pörröllä	['PCLE_IKINÄ']	poss=opt
pöyhkeästi	['PCLE_TYHMÄSTI']	clit=opt
pöyhölle	['PCLE_YLLE']	poss=opt
pöyhöllä	['PCLE_IKINÄ']	poss=opt
raa'asti	['PCLE_NOPEASTI']	clit=opt
radikaalisesti	['PCLE_NOPEASTI']	clit=opt
radikaalisti	['PCLE_NOPEASTI']	clit=opt
radioaktiivisesti	['PCLE_NOPEASTI']	clit=opt
raflaavasti	['PCLE_NOPEASTI']	clit=opt
rahallisesti	['PCLE_NOPEASTI']	clit=opt
rahtivapaasti	['PCLE_NOPEASTI']	clit=opt
rahvaanomaisesti	['PCLE_NOPEASTI']	clit=opt
raihnaisesti	['PCLE_NOPEASTI']	clit=opt
railakkaasti	['PCLE_NOPEASTI']	clit=opt
raisusti	['PCLE_NOPEASTI']	clit=opt
raittiisti	['PCLE_NOPEASTI']	clit=opt
raivoisasti	['PCLE_NOPEASTI']	clit=opt
raivokkaasti	['PCLE_NOPEASTI']	clit=opt
rajallisesti	['PCLE_NOPEASTI']	clit=opt
rajattomasti	['PCLE_NOPEASTI']	clit=opt
rajoitetusti	['PCLE_NOPEASTI']	clit=opt
rajusti	['PCLE_NOPEASTI']	clit=opt
rakastettavasti	['PCLE_NOPEASTI']	clit=opt
rakenteellisesti	['PCLE_NOPEASTI']	clit=opt
rankasti	['PCLE_NOPEASTI']	clit=opt
rasistisesti	['PCLE_NOPEASTI']	clit=opt
rasittavasti	['PCLE_NOPEASTI']	clit=opt
raskaasti	['PCLE_NOPEASTI']	clit=opt
rationaalisesti	['PCLE_NOPEASTI']	clit=opt
ratkaisevasti	['PCLE_NOPEASTI']	clit=opt
rattoisasti	['PCLE_NOPEASTI']	clit=opt
rauhallisesti	['PCLE_NOPEASTI']	clit=opt
rauhattomasti	['PCLE_NOPEASTI']	clit=opt
raukeasti	['PCLE_NOPEASTI']	clit=opt
raukkamaisesti	['PCLE_NOPEASTI']	clit=opt
rautaisesti	['PCLE_NOPEASTI']	clit=opt
ravakasti	['PCLE_NOPEASTI']	clit=opt
ravinto-opillisesti	['PCLE_NOPEASTI']	clit=opt
reaaliaikaisesti	['PCLE_NOPEASTI']	clit=opt
realistisesti	['PCLE_NOPEASTI']	clit=opt
reflektorisesti	['PCLE_NOPEASTI']	clit=opt
rehdisti	['PCLE_TYHMÄSTI']	clit=opt
rehellisesti	['PCLE_TYHMÄSTI']	clit=opt
rehevästi	['PCLE_TYHMÄSTI']	clit=opt
rehvakkaasti	['PCLE_NOPEASTI']	clit=opt
reilusti	['PCLE_NOPEASTI']	clit=opt
reippaasti	['PCLE_NOPEASTI']	clit=opt
remakasti	['PCLE_NOPEASTI']	clit=opt
rempseästi	['PCLE_TYHMÄSTI']	clit=opt
rennosti	['PCLE_NOPEASTI']	clit=opt
repäisevästi	['PCLE_TYHMÄSTI']	clit=opt
resitatiivisesti	['PCLE_NOPEASTI']	clit=opt
reteästi	['PCLE_TYHMÄSTI']	clit=opt
retorisesti	['PCLE_NOPEASTI']	clit=opt
reunalla	['PCLE_KOTONA']	poss=opt
reunalle	['PCLE_ALLE']	poss=opt
reunalta	['PCLE_KOTONA']	poss=opt
reunassa	['PCLE_KOTONA']	poss=opt
reunasta	['PCLE_KOTONA']	poss=opt
riehakkaasti	['PCLE_NOPEASTI']	clit=opt
riemuisasti	['PCLE_NOPEASTI']	clit=opt
riemukkaasti	['PCLE_NOPEASTI']	clit=opt
riettaasti	['PCLE_NOPEASTI']	clit=opt
rigoristisesti	['PCLE_NOPEASTI']	clit=opt
riipaisevasti	['PCLE_NOPEASTI']	clit=opt
riipalla	['PCLE_KOTONA']	poss=opt
riipalle	['PCLE_ALLE']	poss=opt
riippumattomasti	['PCLE_NOPEASTI']	clit=opt
riitaisesti	['PCLE_NOPEASTI']	clit=opt
riittoisasti	['PCLE_NOPEASTI']	clit=opt
riittämättömästi	['PCLE_TYHMÄSTI']	clit=opt
riittävästi	['PCLE_TYHMÄSTI']	clit=opt
riivatusti	['PCLE_NOPEASTI']	clit=opt
rikkaasti	['PCLE_NOPEASTI']	clit=opt
rikkiviisaasti	['PCLE_NOPEASTI']	clit=opt
rikollisesti	['PCLE_NOPEASTI']	clit=opt
rinnakkaisesti	['PCLE_NOPEASTI']	clit=opt
rinnalla	['PCLE_KOTONA']	poss=opt
rinnalle	['PCLE_ALLE']	poss=opt
rinnalta	['PCLE_KOTONA']	poss=opt
ripeästi	['PCLE_TYHMÄSTI']	clit=opt
ristikkäisesti	['PCLE_TYHMÄSTI']	clit=opt
ritarillisesti	['PCLE_NOPEASTI']	clit=opt
riuskasti	['PCLE_NOPEASTI']	clit=opt
rivakasti	['PCLE_NOPEASTI']	clit=opt
riveittäin	['PCLE_NÄKYVIIN']	clit=opt
rivittäin	['PCLE_NÄKYVIIN']	clit=opt
rodullisesti	['PCLE_NOPEASTI']	clit=opt
rohkeasti	['PCLE_NOPEASTI']	clit=opt
roimasti	['PCLE_NOPEASTI']	clit=opt
roistomaisesti	['PCLE_NOPEASTI']	clit=opt
romahdusmaisesti	['PCLE_NOPEASTI']	clit=opt
romanttisesti	['PCLE_NOPEASTI']	clit=opt
ronskisti	['PCLE_NOPEASTI']	clit=opt
rosoisesti	['PCLE_NOPEASTI']	clit=opt
ruhtinaallisesti	['PCLE_NOPEASTI']	clit=opt
rumasti	['PCLE_NOPEASTI']	clit=opt
runollisesti	['PCLE_NOPEASTI']	clit=opt
runsaasti	['PCLE_NOPEASTI']	clit=opt
runsaskätisesti	['PCLE_TYHMÄSTI']	clit=opt
runsaslukuisesti	['PCLE_NOPEASTI']	clit=opt
ruotsalaisittain	['PCLE_VALTAAN']	clit=opt
ruotsinvoittoisesti	['PCLE_NOPEASTI']	clit=opt
rutiiniluonteisesti	['PCLE_NOPEASTI']	clit=opt
rutiinimaisesti	['PCLE_NOPEASTI']	clit=opt
rutkasti	['PCLE_NOPEASTI']	clit=opt
rutosti	['PCLE_NOPEASTI']	clit=opt
ruuduittain	['PCLE_VALTAAN']	clit=opt
ruumiillisesti	['PCLE_NOPEASTI']	clit=opt
ryhdikkäästi	['PCLE_TYHMÄSTI']	clit=opt
ryhdittömästi	['PCLE_TYHMÄSTI']	clit=opt
ryhmittäin	['PCLE_NÄKYVIIN']	clit=opt
rykelmittäin	['PCLE_NÄKYVIIN']	clit=opt
ryppyotsaisesti	['PCLE_NOPEASTI']	clit=opt
rytmikkäästi	['PCLE_TYHMÄSTI']	clit=opt
rytmillisesti	['PCLE_TYHMÄSTI']	clit=opt
rytmisesti	['PCLE_TYHMÄSTI']	clit=opt
ryypyksiin	['PCLE_NÄKYVIIN']	poss=opt
ryypyksissä	['PCLE_IKINÄ']	poss=opt
räikeästi	['PCLE_TYHMÄSTI']	clit=opt
räiskyvästi	['PCLE_TYHMÄSTI']	clit=opt
räjähdysmäisesti	['PCLE_TYHMÄSTI']	clit=opt
räkäisesti	['PCLE_TYHMÄSTI']	clit=opt
rämeästi	['PCLE_TYHMÄSTI']	clit=opt
rämäkästi	['PCLE_TYHMÄSTI']	clit=opt
rämäpäisesti	['PCLE_TYHMÄSTI']	clit=opt
räväkästi	['PCLE_TYHMÄSTI']	clit=opt
räävittömästi	['PCLE_TYHMÄSTI']	clit=opt
rääväsuisesti	['PCLE_NOPEASTI']	clit=opt
rökkiin	['PCLE_NÄKYVIIN']	poss=opt
römeästi	['PCLE_TYHMÄSTI']	clit=opt
röyhkeästi	['PCLE_TYHMÄSTI']	clit=opt
röykkiöittäin	['PCLE_NÄKYVIIN']	clit=opt
saakelisti	['PCLE_NOPEASTI']	clit=opt
saakuristi	['PCLE_NOPEASTI']	clit=opt
saamaristi	['PCLE_NOPEASTI']	clit=opt
saatanasti	['PCLE_NOPEASTI']	clit=opt
sadasti	['PCLE_NOPEASTI']	clit=opt
sadistisesti	['PCLE_NOPEASTI']	clit=opt
sadoittain	['PCLE_VALTAAN']	clit=opt
sadunomaisesti	['PCLE_NOPEASTI']	clit=opt
saidasti	['PCLE_NOPEASTI']	clit=opt
sairaalloisesti	['PCLE_NOPEASTI']	clit=opt
sairaasti	['PCLE_NOPEASTI']	clit=opt
salaisesti	['PCLE_NOPEASTI']	clit=opt
salakavalasti	['PCLE_NOPEASTI']	clit=opt
salakähmäisesti	['PCLE_TYHMÄSTI']	clit=opt
salamannopeasti	['PCLE_NOPEASTI']	clit=opt
salamyhkäisesti	['PCLE_TYHMÄSTI']	clit=opt
salaperäisesti	['PCLE_TYHMÄSTI']	clit=opt
salavihkaisesti	['PCLE_NOPEASTI']	clit=opt
sallivasti	['PCLE_NOPEASTI']	clit=opt
salonkikelpoisesti	['PCLE_NOPEASTI']	clit=opt
samanaikaisesti	['PCLE_NOPEASTI']	clit=opt
samankaltaisesti	['PCLE_NOPEASTI']	clit=opt
samankeskisesti	['PCLE_NOPEASTI']	clit=opt
samansuuntaisesti	['PCLE_NOPEASTI']	clit=opt
samperisti	['PCLE_NOPEASTI']	clit=opt
-sanaisesti	['PCLE_NOPEASTI']	clit=opt
sanallisesti	['PCLE_NOPEASTI']	clit=opt
sananmukaisesti	['PCLE_NOPEASTI']	clit=opt
sanatarkasti	['PCLE_NOPEASTI']	clit=opt
sanattomasti	['PCLE_NOPEASTI']	clit=opt
sankarillisesti	['PCLE_NOPEASTI']	clit=opt
sankasti	['PCLE_NOPEASTI']	clit=opt
sanomattomasti	['PCLE_NOPEASTI']	clit=opt
sanottavasti	['PCLE_NOPEASTI']	clit=opt
sapekkaasti	['PCLE_NOPEASTI']	clit=opt
sarjoittain	['PCLE_VALTAAN']	clit=opt
sarkastisesti	['PCLE_NOPEASTI']	clit=opt
satakertaisesti	['PCLE_NOPEASTI']	clit=opt
sataprosenttisesti	['PCLE_NOPEASTI']	clit=opt
satavuotisesti	['PCLE_NOPEASTI']	clit=opt
sattumanvaraisesti	['PCLE_NOPEASTI']	clit=opt
sattuvasti	['PCLE_NOPEASTI']	clit=opt
satunnaisesti	['PCLE_NOPEASTI']	clit=opt
saumattomasti	['PCLE_NOPEASTI']	clit=opt
savolaisittain	['PCLE_VALTAAN']	clit=opt
seestyneesti	['PCLE_TYHMÄSTI']	clit=opt
seikkaperäisesti	['PCLE_TYHMÄSTI']	clit=opt
seisaalla	['PCLE_KOTONA']	poss=opt
seisaalle	['PCLE_ALLE']	poss=opt
seisaalta	['PCLE_KOTONA']	poss=opt
seisoalla	['PCLE_KOTONA']	poss=opt
seisoalle	['PCLE_ALLE']	poss=opt
seisoalta	['PCLE_KOTONA']	poss=opt
seisovilla	['PCLE_KOTONA']	poss=opt
seisoville	['PCLE_ALLE']	poss=opt
seisovilta	['PCLE_KOTONA']	poss=obl
seitsemästi	['PCLE_TYHMÄSTI']	clit=opt
sekaisesti	['PCLE_NOPEASTI']	clit=opt
sekapäisesti	['PCLE_TYHMÄSTI']	clit=opt
sekasortoisesti	['PCLE_NOPEASTI']	clit=opt
sekavasti	['PCLE_NOPEASTI']	clit=opt
seksikkäästi	['PCLE_TYHMÄSTI']	clit=opt
seksuaalisesti	['PCLE_NOPEASTI']	clit=opt
sekularistisesti	['PCLE_NOPEASTI']	clit=opt
sekundaarisesti	['PCLE_NOPEASTI']	clit=opt
sekundaaristi	['PCLE_NOPEASTI']	clit=opt
selektiivisesti	['PCLE_TYHMÄSTI']	clit=opt
selittäin	['PCLE_NÄKYVIIN']	clit=opt
selittämättömästi	['PCLE_TYHMÄSTI']	clit=opt
selkeästi	['PCLE_TYHMÄSTI']	clit=opt
-selkäisesti	['PCLE_TYHMÄSTI']	clit=opt
selkärangattomasti	['PCLE_NOPEASTI']	clit=opt
selväkielisesti	['PCLE_TYHMÄSTI']	clit=opt
selvänäköisesti	['PCLE_TYHMÄSTI']	clit=opt
selväpiirteisesti	['PCLE_TYHMÄSTI']	clit=opt
selväsanaisesti	['PCLE_NOPEASTI']	clit=opt
selvästi	['PCLE_TYHMÄSTI']	clit=opt
sensijaan	['PCLE_VALTAAN']	clit=opt
sensitiivisesti	['PCLE_TYHMÄSTI']	clit=opt
sentimentaalisesti	['PCLE_NOPEASTI']	clit=opt
separatistisesti	['PCLE_NOPEASTI']	clit=opt
seremoniallisesti	['PCLE_NOPEASTI']	clit=opt
sesonkiluonteisesti	['PCLE_NOPEASTI']	clit=opt
setämäisesti	['PCLE_TYHMÄSTI']	clit=opt
seudullisesti	['PCLE_NOPEASTI']	clit=opt
seuraavasti	['PCLE_NOPEASTI']	clit=opt
seuranhaluisesti	['PCLE_NOPEASTI']	clit=opt
siedettävästi	['PCLE_TYHMÄSTI']	clit=opt
siekailemattomasti	['PCLE_NOPEASTI']	clit=opt
sielukkaasti	['PCLE_NOPEASTI']	clit=opt
sielullisesti	['PCLE_NOPEASTI']	clit=opt
sietämättömästi	['PCLE_TYHMÄSTI']	clit=opt
sievästi	['PCLE_TYHMÄSTI']	clit=opt
siirtyvästi	['PCLE_TYHMÄSTI']	clit=opt
siististi	['PCLE_TYHMÄSTI']	clit=opt
siivosti	['PCLE_NOPEASTI']	clit=opt
siivottomasti	['PCLE_NOPEASTI']	clit=opt
sikamaisesti	['PCLE_NOPEASTI']	clit=opt
sikeästi	['PCLE_TYHMÄSTI']	clit=opt
sikkaralla	['PCLE_KOTONA']	poss=opt
sikkaralle	['PCLE_ALLE']	poss=opt
siksi	['PCLE_LISÄKSI']	clit=opt
sileästi	['PCLE_TYHMÄSTI']	clit=opt
silleen	['PCLE_NÄKYVIIN']	clit=opt
silloin	['PCLE_VALTAAN']	clit=opt
silmiinpistävästi	['PCLE_TYHMÄSTI']	clit=opt
silminnähtävästi	['PCLE_TYHMÄSTI']	clit=opt
silmittömästi	['PCLE_TYHMÄSTI']	clit=opt
-silmäisesti	['PCLE_TYHMÄSTI']	clit=opt
silmämääräisesti	['PCLE_TYHMÄSTI']	clit=opt
silmässä	['PCLE_IKINÄ']	poss=opt
silmästä	['PCLE_IKINÄ']	poss=opt
siloisesti	['PCLE_NOPEASTI']	clit=opt
simppelisti	['PCLE_TYHMÄSTI']	clit=opt
simultaanisesti	['PCLE_NOPEASTI']	clit=opt
simultaanisti	['PCLE_NOPEASTI']	clit=opt
sinisilmäisesti	['PCLE_TYHMÄSTI']	clit=opt
sinnikkäästi	['PCLE_TYHMÄSTI']	clit=opt
sirrille	['PCLE_YLLE']	poss=obl
sirrillä	['PCLE_IKINÄ']	poss=obl
sisarellisesti	['PCLE_NOPEASTI']	clit=opt
sisimmältä	['PCLE_IKINÄ']	poss=obl
sisukkaasti	['PCLE_NOPEASTI']	clit=opt
sisäisesti	['PCLE_TYHMÄSTI']	clit=opt
sisälle	['PCLE_YLLE']	poss=opt
sisällisesti	['PCLE_TYHMÄSTI']	clit=opt
sisällä	['PCLE_IKINÄ']	poss=opt
sisältä	['PCLE_IKINÄ']	poss=opt
sisäpoliittisesti	['PCLE_NOPEASTI']	clit=opt
sisässä	['PCLE_IKINÄ']	poss=opt
sisästä	['PCLE_IKINÄ']	poss=opt
sisättäin	['PCLE_NÄKYVIIN']	clit=opt
sisään	['PCLE_NÄKYVIIN']	poss=opt
siten	['PCLE_NÄKYVIIN']	clit=opt
sitkaasti	['PCLE_NOPEASTI']	clit=opt
sitkeästi	['PCLE_TYHMÄSTI']	clit=opt
sitovasti	['PCLE_NOPEASTI']	clit=opt
siveellisesti	['PCLE_TYHMÄSTI']	clit=opt
siveettömästi	['PCLE_TYHMÄSTI']	clit=opt
siveästi	['PCLE_TYHMÄSTI']	clit=opt
sivistymättömästi	['PCLE_TYHMÄSTI']	clit=opt
sivistyneesti	['PCLE_TYHMÄSTI']	clit=opt
sivuitse	['PCLE_ALLE']	poss=opt
sivuittain	['PCLE_VALTAAN']	clit=opt
sivuttain	['PCLE_VALTAAN']	clit=opt
skeptisesti	['PCLE_TYHMÄSTI']	clit=opt
skitsofreenisesti	['PCLE_NOPEASTI']	clit=opt
snobistisesti	['PCLE_NOPEASTI']	clit=opt
soinnikkaasti	['PCLE_NOPEASTI']	clit=opt
soinnillisesti	['PCLE_NOPEASTI']	clit=opt
soinnittomasti	['PCLE_NOPEASTI']	clit=opt
soinnukkaasti	['PCLE_NOPEASTI']	clit=opt
soinnullisesti	['PCLE_NOPEASTI']	clit=opt
sokeasti	['PCLE_NOPEASTI']	clit=opt
solidaarisesti	['PCLE_NOPEASTI']	clit=opt
somasti	['PCLE_NOPEASTI']	clit=opt
sopimattomasti	['PCLE_NOPEASTI']	clit=opt
sopivasti	['PCLE_NOPEASTI']	clit=opt
sopuisasti	['PCLE_NOPEASTI']	clit=opt
sopusointuisesti	['PCLE_NOPEASTI']	clit=opt
sopusuhtaisesti	['PCLE_NOPEASTI']	clit=opt
soreasti	['PCLE_NOPEASTI']	clit=opt
sosiaalisesti	['PCLE_NOPEASTI']	clit=opt
sotaisasti	['PCLE_NOPEASTI']	clit=opt
sotaisesti	['PCLE_NOPEASTI']	clit=opt
sotilaallisesti	['PCLE_NOPEASTI']	clit=opt
sotilaspoliittisesti	['PCLE_NOPEASTI']	clit=opt
sotkuisesti	['PCLE_NOPEASTI']	clit=opt
sovinistisesti	['PCLE_NOPEASTI']	clit=opt
sovinnaisesti	['PCLE_NOPEASTI']	clit=opt
sovinnollisesti	['PCLE_NOPEASTI']	clit=opt
sovittelevasti	['PCLE_NOPEASTI']	clit=opt
spatiaalisesti	['PCLE_NOPEASTI']	clit=opt
spontaanisti	['PCLE_NOPEASTI']	clit=opt
sporadisesti	['PCLE_NOPEASTI']	clit=opt
sporttisesti	['PCLE_NOPEASTI']	clit=opt
staattisesti	['PCLE_NOPEASTI']	clit=opt
stereotyyppisesti	['PCLE_TYHMÄSTI']	clit=opt
steriilisti	['PCLE_TYHMÄSTI']	clit=opt
stoalaisesti	['PCLE_NOPEASTI']	clit=opt
strategisesti	['PCLE_NOPEASTI']	clit=opt
strukturalistisesti	['PCLE_NOPEASTI']	clit=opt
subjektiivisesti	['PCLE_NOPEASTI']	clit=opt
suggestiivisesti	['PCLE_NOPEASTI']	clit=opt
suhteellisesti	['PCLE_NOPEASTI']	clit=opt
suhteellisuudentajuisesti	['PCLE_NOPEASTI']	clit=opt
suhteettomasti	['PCLE_NOPEASTI']	clit=opt
sujuvasti	['PCLE_NOPEASTI']	clit=opt
sukkelasti	['PCLE_NOPEASTI']	clit=opt
sukupuolisesti	['PCLE_NOPEASTI']	clit=opt
sulavasti	['PCLE_NOPEASTI']	clit=opt
suloisesti	['PCLE_NOPEASTI']	clit=opt
sulokkaasti	['PCLE_NOPEASTI']	clit=opt
sulosti	['PCLE_NOPEASTI']	clit=opt
summaarisesti	['PCLE_NOPEASTI']	clit=opt
summattomasti	['PCLE_NOPEASTI']	clit=opt
summittain	['PCLE_VALTAAN']	clit=opt
summittaisesti	['PCLE_NOPEASTI']	clit=opt
suomalaisesti	['PCLE_NOPEASTI']	clit=opt
suomalaisittain	['PCLE_VALTAAN']	clit=opt
suonensisäisesti	['PCLE_TYHMÄSTI']	clit=opt
suopeasti	['PCLE_NOPEASTI']	clit=opt
suoranaisesti	['PCLE_NOPEASTI']	clit=opt
suorasti	['PCLE_NOPEASTI']	clit=opt
suorasukaisesti	['PCLE_NOPEASTI']	clit=opt
suoraviivaisesti	['PCLE_NOPEASTI']	clit=opt
suosiollisesti	['PCLE_NOPEASTI']	clit=opt
suotuisasti	['PCLE_NOPEASTI']	clit=opt
supisuomalaisesti	['PCLE_NOPEASTI']	clit=opt
suppeasti	['PCLE_NOPEASTI']	clit=opt
supulla	['PCLE_KOTONA']	poss=opt
supulle	['PCLE_ALLE']	poss=opt
surkeasti	['PCLE_NOPEASTI']	clit=opt
surullisesti	['PCLE_NOPEASTI']	clit=opt
surumielisesti	['PCLE_TYHMÄSTI']	clit=opt
suruttomasti	['PCLE_NOPEASTI']	clit=opt
sutjakasti	['PCLE_NOPEASTI']	clit=opt
suulaasti	['PCLE_NOPEASTI']	clit=opt
suullisesti	['PCLE_NOPEASTI']	clit=opt
suunnattomasti	['PCLE_NOPEASTI']	clit=opt
suunnilleen	['PCLE_VALTAAN']	clit=opt
suunnitelmallisesti	['PCLE_NOPEASTI']	clit=opt
suunnittelemattomasti	['PCLE_NOPEASTI']	clit=opt
suuntaisesti	['PCLE_NOPEASTI']	clit=opt
suurellisesti	['PCLE_TYHMÄSTI']	clit=opt
suurenmoisesti	['PCLE_NOPEASTI']	clit=opt
suuresti	['PCLE_NOPEASTI']	clit=opt
suurieleisesti	['PCLE_TYHMÄSTI']	clit=opt
suurisanaisesti	['PCLE_NOPEASTI']	clit=opt
suurisuisesti	['PCLE_NOPEASTI']	clit=opt
suurisuuntaisesti	['PCLE_NOPEASTI']	clit=opt
suuriäänisesti	['PCLE_TYHMÄSTI']	clit=opt
suurpiirteisesti	['PCLE_TYHMÄSTI']	clit=opt
suussa	['PCLE_KOTONA']	poss=opt
suusta	['PCLE_KOTONA']	poss=opt
suutuksiin	['PCLE_VALTAAN']	poss=opt
suutuksissa	['PCLE_KOTONA']	poss=opt
suvaitsemattomasti	['PCLE_NOPEASTI']	clit=opt
suvaitsevaisesti	['PCLE_NOPEASTI']	clit=opt
suvaitsevasti	['PCLE_NOPEASTI']	clit=opt
suvereenisesti	['PCLE_NOPEASTI']	clit=opt
suvereenisti	['PCLE_NOPEASTI']	clit=opt
suvuittain	['PCLE_VALTAAN']	clit=opt
suvullisesti	['PCLE_NOPEASTI']	clit=opt
suvuttomasti	['PCLE_NOPEASTI']	clit=opt
sydämellisesti	['PCLE_TYHMÄSTI']	clit=opt
sydämettömästi	['PCLE_TYHMÄSTI']	clit=opt
sylittäin	['PCLE_NÄKYVIIN']	clit=opt
symbioottisesti	['PCLE_NOPEASTI']	clit=opt
symbolisesti	['PCLE_NOPEASTI']	clit=opt
symmetrisesti	['PCLE_TYHMÄSTI']	clit=opt
sympaattisesti	['PCLE_NOPEASTI']	clit=opt
synkästi	['PCLE_TYHMÄSTI']	clit=opt
synnillisesti	['PCLE_TYHMÄSTI']	clit=opt
synnynnäisesti	['PCLE_TYHMÄSTI']	clit=opt
synteettisesti	['PCLE_TYHMÄSTI']	clit=opt
syntisesti	['PCLE_TYHMÄSTI']	clit=opt
-syntyisesti	['PCLE_TYHMÄSTI']	clit=opt
syrjittäin	['PCLE_NÄKYVIIN']	clit=opt
systeemisesti	['PCLE_TYHMÄSTI']	clit=opt
systemaattisesti	['PCLE_NOPEASTI']	clit=opt
sysäyksittäin	['PCLE_NÄKYVIIN']	clit=opt
syvällisesti	['PCLE_TYHMÄSTI']	clit=opt
syvästi	['PCLE_TYHMÄSTI']	clit=opt
syyttömästi	['PCLE_TYHMÄSTI']	clit=opt
sähköisesti	['PCLE_TYHMÄSTI']	clit=opt
sähäkästi	['PCLE_TYHMÄSTI']	clit=opt
säkeittäin	['PCLE_NÄKYVIIN']	clit=opt
säntillisesti	['PCLE_TYHMÄSTI']	clit=opt
särmikkäästi	['PCLE_TYHMÄSTI']	clit=opt
säteittäin	['PCLE_NÄKYVIIN']	clit=opt
säteittäisesti	['PCLE_TYHMÄSTI']	clit=opt
sävyisesti	['PCLE_TYHMÄSTI']	clit=opt
sävyisästi	['PCLE_TYHMÄSTI']	clit=opt
säyseästi	['PCLE_TYHMÄSTI']	clit=opt
säädyllisesti	['PCLE_TYHMÄSTI']	clit=opt
säädyttömästi	['PCLE_TYHMÄSTI']	clit=opt
säälimättömästi	['PCLE_TYHMÄSTI']	clit=opt
säällisesti	['PCLE_TYHMÄSTI']	clit=opt
säännöllisesti	['PCLE_TYHMÄSTI']	clit=opt
säännönmukaisesti	['PCLE_NOPEASTI']	clit=opt
säännöttömästi	['PCLE_TYHMÄSTI']	clit=opt
säästeliäästi	['PCLE_TYHMÄSTI']	clit=opt
säästäväisesti	['PCLE_TYHMÄSTI']	clit=opt
-säätöisesti	['PCLE_TYHMÄSTI']	clit=opt
söpösti	['PCLE_TYHMÄSTI']	clit=opt
söötisti	['PCLE_TYHMÄSTI']	clit=opt
taajasti	['PCLE_NOPEASTI']	clit=opt
taakse	['PCLE_ALLE']	poss=opt
taantumuksellisesti	['PCLE_NOPEASTI']	clit=opt
taa	['PCLE_KOTONA']	poss=opt
taatusti	['PCLE_NOPEASTI']	clit=opt
tahallisesti	['PCLE_NOPEASTI']	clit=opt
tahattomasti	['PCLE_NOPEASTI']	clit=opt
tahdikkaasti	['PCLE_NOPEASTI']	clit=opt
tahdittomasti	['PCLE_NOPEASTI']	clit=opt
tahmeasti	['PCLE_NOPEASTI']	clit=opt
taianomaisesti	['PCLE_NOPEASTI']	clit=opt
taidehistoriallisesti	['PCLE_NOPEASTI']	clit=opt
taidokkaasti	['PCLE_NOPEASTI']	clit=opt
taidollisesti	['PCLE_NOPEASTI']	clit=opt
taidottomasti	['PCLE_NOPEASTI']	clit=opt
taikauskoisesti	['PCLE_NOPEASTI']	clit=opt
tainnoksiin	['PCLE_VALTAAN']	poss=opt
tainnoksissa	['PCLE_KOTONA']	poss=opt
tainnoksista	['PCLE_KOTONA']	poss=opt
tainnuksiin	['PCLE_VALTAAN']	poss=opt
tainnuksissa	['PCLE_KOTONA']	poss=opt
tainnuksista	['PCLE_KOTONA']	poss=opt
taipuisasti	['PCLE_NOPEASTI']	clit=opt
taitamattomasti	['PCLE_NOPEASTI']	clit=opt
taitavasti	['PCLE_NOPEASTI']	clit=opt
taiteellisesti	['PCLE_NOPEASTI']	clit=opt
taitse	['PCLE_ALLE']	poss=opt
taiturillisesti	['PCLE_NOPEASTI']	clit=opt
taiturimaisesti	['PCLE_NOPEASTI']	clit=opt
taivaallisesti	['PCLE_NOPEASTI']	clit=opt
tajuisesti	['PCLE_NOPEASTI']	clit=opt
tajuttomasti	['PCLE_NOPEASTI']	clit=opt
takaa	['PCLE_KOTONA']	poss=opt
takana	['PCLE_KOTONA']	poss=opt
takapajuisesti	['PCLE_NOPEASTI']	clit=opt
takaperoisesti	['PCLE_NOPEASTI']	clit=opt
takia	['PCLE_KOTONA']	poss=opt
takkuisesti	['PCLE_NOPEASTI']	clit=opt
taktisesti	['PCLE_NOPEASTI']	clit=opt
taloudellisesti	['PCLE_NOPEASTI']	clit=opt
tanakasti	['PCLE_NOPEASTI']	clit=opt
tanttamaisesti	['PCLE_NOPEASTI']	clit=opt
tapaisesti	['PCLE_NOPEASTI']	clit=opt
tapaturmaisesti	['PCLE_NOPEASTI']	clit=opt
tapauksittain	['PCLE_VALTAAN']	clit=opt
tappiollisesti	['PCLE_NOPEASTI']	clit=opt
tarkalleen	['PCLE_VALTAAN']	clit=opt
tarkasti	['PCLE_NOPEASTI']	clit=opt
tarkkaamattomasti	['PCLE_NOPEASTI']	clit=opt
tarkkaavaisesti	['PCLE_NOPEASTI']	clit=opt
tarkkaavasti	['PCLE_NOPEASTI']	clit=opt
tarkkakätisesti	['PCLE_TYHMÄSTI']	clit=opt
tarkkanäköisesti	['PCLE_TYHMÄSTI']	clit=opt
tarkkasilmäisesti	['PCLE_TYHMÄSTI']	clit=opt
tarkoituksellisesti	['PCLE_NOPEASTI']	clit=opt
tarkoituksenmukaisesti	['PCLE_NOPEASTI']	clit=opt
tarkoituksettomasti	['PCLE_NOPEASTI']	clit=opt
tarkoitushakuisesti	['PCLE_NOPEASTI']	clit=opt
tarmokkaasti	['PCLE_NOPEASTI']	clit=opt
tarpeeksi	['PCLE_VUOKSI']	poss=opt
tarpeettomasti	['PCLE_NOPEASTI']	clit=opt
tarunomaisesti	['PCLE_NOPEASTI']	clit=opt
tasa-arvoisesti	['PCLE_NOPEASTI']	clit=opt
tasaisesti	['PCLE_NOPEASTI']	clit=opt
tasajatkuisesti	['PCLE_NOPEASTI']	clit=opt
tasalla	['PCLE_KOTONA']	poss=opt
tasalle	['PCLE_ALLE']	poss=opt
tasalta	['PCLE_KOTONA']	poss=opt
tasamittaisesti	['PCLE_NOPEASTI']	clit=opt
tasapainoisesti	['PCLE_NOPEASTI']	clit=opt
tasapainottomasti	['PCLE_NOPEASTI']	clit=opt
tasapaksusti	['PCLE_NOPEASTI']	clit=opt
tasapuolisesti	['PCLE_NOPEASTI']	clit=opt
tasapäisesti	['PCLE_TYHMÄSTI']	clit=opt
tasasuhtaisesti	['PCLE_NOPEASTI']	clit=opt
tasatahtisesti	['PCLE_NOPEASTI']	clit=opt
tasavaltaisesti	['PCLE_NOPEASTI']	clit=opt
tasaveroisesti	['PCLE_NOPEASTI']	clit=opt
tasavertaisesti	['PCLE_NOPEASTI']	clit=opt
tasaväkisesti	['PCLE_TYHMÄSTI']	clit=opt
tauottomasti	['PCLE_NOPEASTI']	clit=opt
tautisesti	['PCLE_NOPEASTI']	clit=opt
tautta	['PCLE_KOTONA']	poss=opt
tavallaan	['PCLE_VALTAAN']	clit=opt
tavallisesti	['PCLE_NOPEASTI']	clit=opt
tavanmukaisesti	['PCLE_NOPEASTI']	clit=opt
tavanomaisesti	['PCLE_NOPEASTI']	clit=opt
tavattomasti	['PCLE_NOPEASTI']	clit=opt
tavoitteellisesti	['PCLE_NOPEASTI']	clit=opt
teatraalisesti	['PCLE_NOPEASTI']	clit=opt
teennäisesti	['PCLE_TYHMÄSTI']	clit=opt
teeskentelemättömästi	['PCLE_TYHMÄSTI']	clit=opt
tehdasmaisesti	['PCLE_NOPEASTI']	clit=opt
-tehoisesti	['PCLE_NOPEASTI']	clit=opt
tehokkaasti	['PCLE_NOPEASTI']	clit=opt
tehottomasti	['PCLE_NOPEASTI']	clit=opt
teikäläisittäin	['PCLE_NÄKYVIIN']	clit=opt
teknisesti	['PCLE_TYHMÄSTI']	clit=opt
tekohurskaasti	['PCLE_NOPEASTI']	clit=opt
-tekoisesti	['PCLE_NOPEASTI']	clit=opt
tekopyhästi	['PCLE_TYHMÄSTI']	clit=opt
teleskooppisesti	['PCLE_NOPEASTI']	clit=opt
teloilla	['PCLE_KOTONA']	poss=opt
teloille	['PCLE_ALLE']	poss=opt
teloilta	['PCLE_KOTONA']	poss=opt
teollisesti	['PCLE_NOPEASTI']	clit=opt
teoreettisesti	['PCLE_NOPEASTI']	clit=opt
terhakasti	['PCLE_NOPEASTI']	clit=opt
terhakkaasti	['PCLE_NOPEASTI']	clit=opt
terveellisesti	['PCLE_TYHMÄSTI']	clit=opt
terveesti	['PCLE_TYHMÄSTI']	clit=opt
tervehenkisesti	['PCLE_TYHMÄSTI']	clit=opt
teräväjärkisesti	['PCLE_TYHMÄSTI']	clit=opt
teräväkatseisesti	['PCLE_NOPEASTI']	clit=opt
teräväkielisesti	['PCLE_TYHMÄSTI']	clit=opt
terävänäköisesti	['PCLE_TYHMÄSTI']	clit=opt
teräväsanaisesti	['PCLE_NOPEASTI']	clit=opt
terävästi	['PCLE_TYHMÄSTI']	clit=opt
terävä-älyisesti	['PCLE_TYHMÄSTI']	clit=opt
tiedottomasti	['PCLE_NOPEASTI']	clit=opt
tieteellisesti	['PCLE_TYHMÄSTI']	clit=opt
tietoisesti	['PCLE_NOPEASTI']	clit=opt
tietokoneavusteisesti	['PCLE_NOPEASTI']	clit=opt
tietopuolisesti	['PCLE_NOPEASTI']	clit=opt
tietoteknisesti	['PCLE_TYHMÄSTI']	clit=opt
tiettävästi	['PCLE_TYHMÄSTI']	clit=opt
tietysti	['PCLE_TYHMÄSTI']	clit=opt
tietävästi	['PCLE_TYHMÄSTI']	clit=opt
tiheästi	['PCLE_TYHMÄSTI']	clit=opt
tiiviisti	['PCLE_TYHMÄSTI']	clit=opt
tilapäisesti	['PCLE_TYHMÄSTI']	clit=opt
tilastollisesti	['PCLE_NOPEASTI']	clit=opt
tilastotieteellisesti	['PCLE_NOPEASTI']	clit=opt
tilavasti	['PCLE_NOPEASTI']	clit=opt
tinkimättömästi	['PCLE_TYHMÄSTI']	clit=opt
tipoittain	['PCLE_VALTAAN']	clit=opt
tiukasti	['PCLE_NOPEASTI']	clit=opt
tiukkapipoisesti	['PCLE_NOPEASTI']	clit=opt
todella	['PCLE_KOTONA']	clit=opt
todellisesti	['PCLE_NOPEASTI']	clit=opt
todellisuudentajuisesti	['PCLE_NOPEASTI']	clit=opt
todenmukaisesti	['PCLE_NOPEASTI']	clit=opt
todennäköisesti	['PCLE_TYHMÄSTI']	clit=opt
todesti	['PCLE_NOPEASTI']	clit=opt
todisteellisesti	['PCLE_NOPEASTI']	clit=opt
toimekkaasti	['PCLE_NOPEASTI']	clit=opt
toimeliaasti	['PCLE_NOPEASTI']	clit=opt
toisinsanoen	['PCLE_VALTAAN']	clit=opt
toissijaisesti	['PCLE_NOPEASTI']	clit=opt
toistuvasti	['PCLE_NOPEASTI']	clit=opt
toiveikkaasti	['PCLE_NOPEASTI']	clit=opt
toivottavasti	['PCLE_NOPEASTI']	clit=opt
toivottomasti	['PCLE_NOPEASTI']	clit=opt
tolerantisti	['PCLE_NOPEASTI']	clit=opt
tolkuttomasti	['PCLE_NOPEASTI']	clit=opt
tomerasti	['PCLE_NOPEASTI']	clit=opt
tonaalisesti	['PCLE_NOPEASTI']	clit=opt
tonneittain	['PCLE_VALTAAN']	clit=opt
topakasti	['PCLE_NOPEASTI']	clit=opt
topografisesti	['PCLE_NOPEASTI']	clit=opt
torjuvasti	['PCLE_NOPEASTI']	clit=opt
torkuksissa	['PCLE_KOTONA']	poss=opt
tosiasiallisesti	['PCLE_NOPEASTI']	clit=opt
tosikkomaisesti	['PCLE_NOPEASTI']	clit=opt
totaalisesti	['PCLE_NOPEASTI']	clit=opt
totalitaarisesti	['PCLE_NOPEASTI']	clit=opt
tota	['PCLE_KOTONA']	clit=opt
totisesti	['PCLE_NOPEASTI']	clit=opt
tottelemattomasti	['PCLE_NOPEASTI']	clit=opt
tottelevaisesti	['PCLE_NOPEASTI']	clit=opt
totuudellisesti	['PCLE_NOPEASTI']	clit=opt
totuudenmukaisesti	['PCLE_NOPEASTI']	clit=opt
touhukkaasti	['PCLE_NOPEASTI']	clit=opt
toverillisesti	['PCLE_NOPEASTI']	clit=opt
traagisesti	['PCLE_NOPEASTI']	clit=opt
traditionaalisesti	['PCLE_NOPEASTI']	clit=opt
trendikkäästi	['PCLE_TYHMÄSTI']	clit=opt
triviaalisti	['PCLE_NOPEASTI']	clit=opt
tuella	['PCLE_KOTONA']	poss=opt
tuhannesti	['PCLE_NOPEASTI']	clit=opt
tuhansittain	['PCLE_VALTAAN']	clit=opt
tuhatkertaisesti	['PCLE_NOPEASTI']	clit=opt
tuhdisti	['PCLE_NOPEASTI']	clit=opt
tuhmasti	['PCLE_NOPEASTI']	clit=opt
tuhoisasti	['PCLE_NOPEASTI']	clit=opt
tuhottomasti	['PCLE_NOPEASTI']	clit=opt
tuhruisesti	['PCLE_NOPEASTI']	clit=opt
tuikeasti	['PCLE_NOPEASTI']	clit=opt
tuimasti	['PCLE_NOPEASTI']	clit=opt
tuittupäisesti	['PCLE_TYHMÄSTI']	clit=opt
tukalasti	['PCLE_NOPEASTI']	clit=opt
tukevasti	['PCLE_NOPEASTI']	clit=opt
tukkoisesti	['PCLE_NOPEASTI']	clit=opt
tukuittain	['PCLE_VALTAAN']	clit=opt
tulisesti	['PCLE_NOPEASTI']	clit=opt
tulkinnanvaraisesti	['PCLE_NOPEASTI']	clit=opt
tullittomasti	['PCLE_NOPEASTI']	clit=opt
tuloksekkaasti	['PCLE_NOPEASTI']	clit=opt
tuloksellisesti	['PCLE_NOPEASTI']	clit=opt
tungettelevasti	['PCLE_NOPEASTI']	clit=opt
tunkeilevasti	['PCLE_NOPEASTI']	clit=opt
tunneittain	['PCLE_VALTAAN']	clit=opt
tunnekylläisesti	['PCLE_TYHMÄSTI']	clit=opt
tunneperäisesti	['PCLE_TYHMÄSTI']	clit=opt
tunnetusti	['PCLE_NOPEASTI']	clit=opt
tunnokkaasti	['PCLE_NOPEASTI']	clit=opt
tunnollisesti	['PCLE_NOPEASTI']	clit=opt
tunnontarkasti	['PCLE_NOPEASTI']	clit=opt
tunnottomasti	['PCLE_NOPEASTI']	clit=opt
tunnustuksellisesti	['PCLE_NOPEASTI']	clit=opt
tunteellisesti	['PCLE_NOPEASTI']	clit=opt
tunteenomaisesti	['PCLE_NOPEASTI']	clit=opt
tunteettomasti	['PCLE_NOPEASTI']	clit=opt
tunteikkaasti	['PCLE_NOPEASTI']	clit=opt
-tunteisesti	['PCLE_NOPEASTI']	clit=opt
-tuntoisesti	['PCLE_NOPEASTI']	clit=opt
tuntuisesti	['PCLE_NOPEASTI']	clit=opt
tuntuvasti	['PCLE_NOPEASTI']	clit=opt
tuohduksiin	['PCLE_VALTAAN']	poss=opt
tuohduksissa	['PCLE_KOTONA']	poss=opt
tuopeittain	['PCLE_VALTAAN']	clit=opt
tuoreesti	['PCLE_NOPEASTI']	clit=opt
tuottamattomasti	['PCLE_NOPEASTI']	clit=opt
tuottamuksellisesti	['PCLE_NOPEASTI']	clit=opt
tuottavasti	['PCLE_NOPEASTI']	clit=opt
tuotteliaasti	['PCLE_NOPEASTI']	clit=opt
tuottoisasti	['PCLE_NOPEASTI']	clit=opt
tuplasti	['PCLE_NOPEASTI']	clit=opt
turhamaisesti	['PCLE_NOPEASTI']	clit=opt
turhanpäiväisesti	['PCLE_TYHMÄSTI']	clit=opt
turhantarkasti	['PCLE_NOPEASTI']	clit=opt
turkasesti	['PCLE_NOPEASTI']	clit=opt
turmiollisesti	['PCLE_NOPEASTI']	clit=opt
turvallisesti	['PCLE_NOPEASTI']	clit=opt
tusinoittain	['PCLE_VALTAAN']	clit=opt
tuskaisasti	['PCLE_NOPEASTI']	clit=opt
tuskaisesti	['PCLE_NOPEASTI']	clit=opt
tuskallisesti	['PCLE_NOPEASTI']	clit=opt
tuskattomasti	['PCLE_NOPEASTI']	clit=opt
tutkivasti	['PCLE_NOPEASTI']	clit=opt
tuttavallisesti	['PCLE_NOPEASTI']	clit=opt
tutunomaisesti	['PCLE_NOPEASTI']	clit=opt
tutusti	['PCLE_NOPEASTI']	clit=opt
tuulenpitävästi	['PCLE_TYHMÄSTI']	clit=opt
tyhjentävästi	['PCLE_TYHMÄSTI']	clit=opt
tyhjänpäiväisesti	['PCLE_TYHMÄSTI']	clit=opt
tyhmänrohkeasti	['PCLE_NOPEASTI']	clit=opt
tyhmästi	['PCLE_TYHMÄSTI']	clit=opt
tykönä	['PCLE_IKINÄ']	poss=opt
tykö	['PCLE_LISÄKSI']	poss=opt
tyköä	['PCLE_IKINÄ']	poss=opt
tylpästi	['PCLE_TYHMÄSTI']	clit=opt
tylysti	['PCLE_TYHMÄSTI']	clit=opt
tympeästi	['PCLE_TYHMÄSTI']	clit=opt
tynnyreittäin	['PCLE_NÄKYVIIN']	clit=opt
typerryksiin	['PCLE_NÄKYVIIN']	poss=opt
typerryksissä	['PCLE_IKINÄ']	poss=opt
typerryksistä	['PCLE_IKINÄ']	poss=opt
typerästi	['PCLE_TYHMÄSTI']	clit=opt
tyrannimaisesti	['PCLE_NOPEASTI']	clit=opt
tyttömäisesti	['PCLE_TYHMÄSTI']	clit=opt
tyydyttävästi	['PCLE_TYHMÄSTI']	clit=opt
tyylikkäästi	['PCLE_TYHMÄSTI']	clit=opt
tyylillisesti	['PCLE_TYHMÄSTI']	clit=opt
tyylinmukaisesti	['PCLE_NOPEASTI']	clit=opt
tyylisesti	['PCLE_TYHMÄSTI']	clit=opt
tyylittömästi	['PCLE_TYHMÄSTI']	clit=opt
tyynesti	['PCLE_TYHMÄSTI']	clit=opt
tyypeittäin	['PCLE_NÄKYVIIN']	clit=opt
tyypillisesti	['PCLE_TYHMÄSTI']	clit=opt
tyytymättömästi	['PCLE_TYHMÄSTI']	clit=opt
tyytyväisesti	['PCLE_TYHMÄSTI']	clit=opt
työläästi	['PCLE_TYHMÄSTI']	clit=opt
tähdellisesti	['PCLE_TYHMÄSTI']	clit=opt
tähysteisesti	['PCLE_TYHMÄSTI']	clit=opt
täpärästi	['PCLE_TYHMÄSTI']	clit=opt
tärkeilevästi	['PCLE_TYHMÄSTI']	clit=opt
tärkeästi	['PCLE_TYHMÄSTI']	clit=opt
täsmällisesti	['PCLE_TYHMÄSTI']	clit=opt
tätimäisesti	['PCLE_TYHMÄSTI']	clit=opt
täydellisesti	['PCLE_TYHMÄSTI']	clit=opt
täydesti	['PCLE_TYHMÄSTI']	clit=opt
täynnä	['PCLE_IKINÄ']	poss=opt
täysilukuisesti	['PCLE_NOPEASTI']	clit=opt
täysimittaisesti	['PCLE_NOPEASTI']	clit=opt
täysimääräisesti	['PCLE_TYHMÄSTI']	clit=opt
täysipainoisesti	['PCLE_NOPEASTI']	clit=opt
täysipäiväisesti	['PCLE_TYHMÄSTI']	clit=opt
täysitehoisesti	['PCLE_NOPEASTI']	clit=opt
täysivaltaisesti	['PCLE_NOPEASTI']	clit=opt
täysivoimaisesti	['PCLE_NOPEASTI']	clit=opt
täyspäisesti	['PCLE_TYHMÄSTI']	clit=opt
täyspäiväisesti	['PCLE_TYHMÄSTI']	clit=opt
täyteläisesti	['PCLE_TYHMÄSTI']	clit=opt
töhryisesti	['PCLE_TYHMÄSTI']	clit=opt
tökerösti	['PCLE_TYHMÄSTI']	clit=opt
törkeästi	['PCLE_TYHMÄSTI']	clit=opt
törkyisesti	['PCLE_TYHMÄSTI']	clit=opt
töykeästi	['PCLE_TYHMÄSTI']	clit=opt
uhkaavasti	['PCLE_NOPEASTI']	clit=opt
uhkarohkeasti	['PCLE_NOPEASTI']	clit=opt
uhkeasti	['PCLE_NOPEASTI']	clit=opt
uhmakkaasti	['PCLE_NOPEASTI']	clit=opt
uhmamielisesti	['PCLE_TYHMÄSTI']	clit=opt
uhmapäisesti	['PCLE_TYHMÄSTI']	clit=opt
uhrautuvasti	['PCLE_NOPEASTI']	clit=opt
ujostelemattomasti	['PCLE_NOPEASTI']	clit=opt
ujosti	['PCLE_NOPEASTI']	clit=opt
uljaasti	['PCLE_NOPEASTI']	clit=opt
ulkoisesti	['PCLE_NOPEASTI']	clit=opt
ulkokohtaisesti	['PCLE_NOPEASTI']	clit=opt
ulkokultaisesti	['PCLE_NOPEASTI']	clit=opt
ulkonaisesti	['PCLE_NOPEASTI']	clit=opt
ulkopoliittisesti	['PCLE_NOPEASTI']	clit=opt
ulottuviin	['PCLE_VALTAAN']	poss=opt
ulottuvilla	['PCLE_KOTONA']	poss=opt
ulottuville	['PCLE_ALLE']	poss=opt
ulottuvilta	['PCLE_KOTONA']	poss=opt
ulottuvissa	['PCLE_KOTONA']	poss=opt
ulottuvista	['PCLE_KOTONA']	poss=opt
umpimielisesti	['PCLE_TYHMÄSTI']	clit=opt
umpimähkäisesti	['PCLE_TYHMÄSTI']	clit=opt
umpinaisesti	['PCLE_NOPEASTI']	clit=opt
uneliaasti	['PCLE_NOPEASTI']	clit=opt
unisesti	['PCLE_NOPEASTI']	clit=opt
unohtumattomasti	['PCLE_NOPEASTI']	clit=opt
upeasti	['PCLE_NOPEASTI']	clit=opt
uppiniskaisesti	['PCLE_NOPEASTI']	clit=opt
uraauurtavasti	['PCLE_NOPEASTI']	clit=opt
urbaanisesti	['PCLE_NOPEASTI']	clit=opt
urbaanisti	['PCLE_NOPEASTI']	clit=opt
urheasti	['PCLE_NOPEASTI']	clit=opt
urhoollisesti	['PCLE_NOPEASTI']	clit=opt
useasti	['PCLE_NOPEASTI']	clit=opt
uskaliaasti	['PCLE_NOPEASTI']	clit=opt
-uskoisesti	['PCLE_NOPEASTI']	clit=opt
uskollisesti	['PCLE_NOPEASTI']	clit=opt
uskomattomasti	['PCLE_NOPEASTI']	clit=opt
uskonnollisesti	['PCLE_NOPEASTI']	clit=opt
uskottavasti	['PCLE_NOPEASTI']	clit=opt
uteliaasti	['PCLE_NOPEASTI']	clit=opt
utopistisesti	['PCLE_NOPEASTI']	clit=opt
uupumattomasti	['PCLE_NOPEASTI']	clit=opt
uusrahvaanomaisesti	['PCLE_NOPEASTI']	clit=opt
uutterasti	['PCLE_NOPEASTI']	clit=opt
uuvuksiin	['PCLE_VALTAAN']	poss=opt
uuvuksissa	['PCLE_KOTONA']	poss=opt
vaan	['PCLE_VALTAAN']	clit=opt
vaarallisesti	['PCLE_NOPEASTI']	clit=opt
vaateliaasti	['PCLE_NOPEASTI']	clit=opt
vaatimattomasti	['PCLE_NOPEASTI']	clit=opt
vaativasti	['PCLE_NOPEASTI']	clit=opt
vahingollisesti	['PCLE_NOPEASTI']	clit=opt
vahingoniloisesti	['PCLE_NOPEASTI']	clit=opt
vahvasti	['PCLE_NOPEASTI']	clit=opt
vaiheittain	['PCLE_VALTAAN']	clit=opt
vaiheittaisesti	['PCLE_NOPEASTI']	clit=opt
vaihtoehtoisesti	['PCLE_NOPEASTI']	clit=opt
vaikeaselkoisesti	['PCLE_NOPEASTI']	clit=opt
vaikeasti	['PCLE_NOPEASTI']	clit=opt
vaikeatajuisesti	['PCLE_NOPEASTI']	clit=opt
vaikka	['PCLE_KOTONA']	clit=opt
vaikuttavasti	['PCLE_NOPEASTI']	clit=opt
-vaikutteisesti	['PCLE_NOPEASTI']	clit=opt
vaillinaisesti	['PCLE_NOPEASTI']	clit=opt
-vaistoisesti	['PCLE_NOPEASTI']	clit=opt
vaistomaisesti	['PCLE_NOPEASTI']	clit=opt
vaistonvaraisesti	['PCLE_NOPEASTI']	clit=opt
vaisusti	['PCLE_NOPEASTI']	clit=opt
vaiteliaasti	['PCLE_NOPEASTI']	clit=opt
vaitonaisesti	['PCLE_NOPEASTI']	clit=opt
vaivaisesti	['PCLE_NOPEASTI']	clit=opt
vaivalloisesti	['PCLE_NOPEASTI']	clit=opt
vaivattomasti	['PCLE_NOPEASTI']	clit=opt
vajaatehoisesti	['PCLE_NOPEASTI']	clit=opt
vajanaisesti	['PCLE_NOPEASTI']	clit=opt
vajavaisesti	['PCLE_NOPEASTI']	clit=opt
vakaasti	['PCLE_NOPEASTI']	clit=opt
vakaumuksellisesti	['PCLE_NOPEASTI']	clit=opt
vakavasti	['PCLE_NOPEASTI']	clit=opt
vakinaisesti	['PCLE_NOPEASTI']	clit=opt
vakituisesti	['PCLE_NOPEASTI']	clit=opt
vakuuttavasti	['PCLE_NOPEASTI']	clit=opt
valaehtoisesti	['PCLE_NOPEASTI']	clit=opt
valheellisesti	['PCLE_NOPEASTI']	clit=opt
valinnaisesti	['PCLE_NOPEASTI']	clit=opt
valitettavasti	['PCLE_NOPEASTI']	clit=opt
valjusti	['PCLE_NOPEASTI']	clit=opt
vallalla	['PCLE_KOTONA']	poss=opt
vallalle	['PCLE_ALLE']	poss=opt
vallankumouksellisesti	['PCLE_NOPEASTI']	clit=opt
vallassa	['PCLE_KOTONA']	poss=opt
vallasta	['PCLE_KOTONA']	poss=opt
vallattomasti	['PCLE_NOPEASTI']	clit=opt
vallitsevasti	['PCLE_NOPEASTI']	clit=opt
valloittavasti	['PCLE_NOPEASTI']	clit=opt
valmistavasti	['PCLE_NOPEASTI']	clit=opt
valoisasti	['PCLE_NOPEASTI']	clit=opt
valokuvauksellisesti	['PCLE_NOPEASTI']	clit=opt
valossa	['PCLE_KOTONA']	clit=opt
valossa	['PCLE_KOTONA']	poss=opt
valppaasti	['PCLE_NOPEASTI']	clit=opt
valtaan	['PCLE_VALTAAN']	poss=opt
valtaisasti	['PCLE_NOPEASTI']	clit=opt
-valtaisesti	['PCLE_NOPEASTI']	clit=opt
valtakunnallisesti	['PCLE_NOPEASTI']	clit=opt
valtavasti	['PCLE_NOPEASTI']	clit=opt
valtioviisaasti	['PCLE_NOPEASTI']	clit=opt
valtoimesti	['PCLE_NOPEASTI']	clit=opt
valveilla	['PCLE_KOTONA']	poss=opt
valveille	['PCLE_ALLE']	poss=opt
vanhahtavasti	['PCLE_NOPEASTI']	clit=opt
vanhanaikaisesti	['PCLE_NOPEASTI']	clit=opt
vanhoillisesti	['PCLE_NOPEASTI']	clit=opt
vankasti	['PCLE_NOPEASTI']	clit=opt
vankkumattomasti	['PCLE_NOPEASTI']	clit=opt
vapaaehtoisesti	['PCLE_NOPEASTI']	clit=opt
vapaamielisesti	['PCLE_TYHMÄSTI']	clit=opt
vapaamuotoisesti	['PCLE_NOPEASTI']	clit=opt
vapaasti	['PCLE_NOPEASTI']	clit=opt
varaan	['PCLE_VALTAAN']	poss=opt
-varaisesti	['PCLE_NOPEASTI']	clit=opt
varakkaasti	['PCLE_NOPEASTI']	clit=opt
varassa	['PCLE_KOTONA']	poss=opt
varasta	['PCLE_KOTONA']	poss=opt
varauksellisesti	['PCLE_NOPEASTI']	clit=opt
varauksettomasti	['PCLE_NOPEASTI']	clit=opt
varmasti	['PCLE_NOPEASTI']	clit=opt
varomattomasti	['PCLE_NOPEASTI']	clit=opt
varovaisesti	['PCLE_NOPEASTI']	clit=opt
varovasti	['PCLE_NOPEASTI']	clit=opt
varpailla	['PCLE_KOTONA']	poss=opt
varpaille	['PCLE_ALLE']	poss=opt
varsinaisesti	['PCLE_NOPEASTI']	clit=opt
vasemmistolaisesti	['PCLE_NOPEASTI']	clit=opt
vasenkätisesti	['PCLE_TYHMÄSTI']	clit=opt
vasituisesti	['PCLE_NOPEASTI']	clit=opt
vastaan	['PCLE_LIKI']	poss=opt
vastaanottavaisesti	['PCLE_NOPEASTI']	clit=opt
vastaanottavasti	['PCLE_NOPEASTI']	clit=opt
vastaan	['PCLE_VALTAAN']	poss=opt
vastaansanomattomasti	['PCLE_NOPEASTI']	clit=opt
vastaavanlaisesti	['PCLE_NOPEASTI']	clit=opt
vastaavasti	['PCLE_NOPEASTI']	clit=opt
vastahakoisesti	['PCLE_NOPEASTI']	clit=opt
vastaisesti	['PCLE_NOPEASTI']	clit=opt
vastakkaisesti	['PCLE_NOPEASTI']	clit=opt
vastassa	['PCLE_KOTONA']	poss=opt
vastavuoroisesti	['PCLE_NOPEASTI']	clit=opt
vastenmielisesti	['PCLE_NOPEASTI']	clit=opt
vastentahtoisesti	['PCLE_NOPEASTI']	clit=opt
-vastuisesti	['PCLE_NOPEASTI']	clit=opt
vastuksellisesti	['PCLE_NOPEASTI']	clit=opt
vastustamattomasti	['PCLE_NOPEASTI']	clit=opt
vastustushaluisesti	['PCLE_NOPEASTI']	clit=opt
vastuullisesti	['PCLE_NOPEASTI']	clit=opt
vastuuntunnottomasti	['PCLE_NOPEASTI']	clit=opt
vastuuntuntoisesti	['PCLE_NOPEASTI']	clit=opt
vastuuttomasti	['PCLE_NOPEASTI']	clit=opt
vauhdikkaasti	['PCLE_NOPEASTI']	clit=opt
vauraasti	['PCLE_NOPEASTI']	clit=opt
vedenpitävästi	['PCLE_TYHMÄSTI']	clit=opt
veikeästi	['PCLE_TYHMÄSTI']	clit=opt
veitikkamaisesti	['PCLE_NOPEASTI']	clit=opt
veljellisesti	['PCLE_TYHMÄSTI']	clit=opt
velmusti	['PCLE_NOPEASTI']	clit=opt
veltosti	['PCLE_NOPEASTI']	clit=opt
velvollisuudentuntoisesti	['PCLE_NOPEASTI']	clit=opt
verenhimoisesti	['PCLE_NOPEASTI']	clit=opt
verisesti	['PCLE_TYHMÄSTI']	clit=opt
verkkaisasti	['PCLE_NOPEASTI']	clit=opt
verkkaisesti	['PCLE_NOPEASTI']	clit=opt
veroisesti	['PCLE_NOPEASTI']	clit=opt
verotuksellisesti	['PCLE_NOPEASTI']	clit=opt
verrannollisesti	['PCLE_NOPEASTI']	clit=opt
verrattain	['PCLE_VALTAAN']	clit=opt
verrattomasti	['PCLE_NOPEASTI']	clit=opt
verrattuna	['PCLE_KOTONA']	clit=opt
vertaisesti	['PCLE_NOPEASTI']	clit=opt
vertauskuvallisesti	['PCLE_NOPEASTI']	clit=opt
vetelästi	['PCLE_TYHMÄSTI']	clit=opt
vetävästi	['PCLE_TYHMÄSTI']	clit=opt
viattomasti	['PCLE_NOPEASTI']	clit=opt
viehkeästi	['PCLE_TYHMÄSTI']	clit=opt
viehkosti	['PCLE_NOPEASTI']	clit=opt
viehättävästi	['PCLE_TYHMÄSTI']	clit=opt
viekkaasti	['PCLE_NOPEASTI']	clit=opt
vienosti	['PCLE_NOPEASTI']	clit=opt
vieraanvaraisesti	['PCLE_NOPEASTI']	clit=opt
vieraanvoittoisesti	['PCLE_NOPEASTI']	clit=opt
viereen	['PCLE_NÄKYVIIN']	poss=opt
vierelle	['PCLE_YLLE']	poss=opt
vierellä	['PCLE_IKINÄ']	poss=opt
viereltä	['PCLE_IKINÄ']	poss=opt
vieressä	['PCLE_IKINÄ']	poss=opt
vierestä	['PCLE_IKINÄ']	poss=opt
vierettäin	['PCLE_NÄKYVIIN']	clit=opt
vieritse	['PCLE_YLLE']	poss=opt
viettelevästi	['PCLE_TYHMÄSTI']	clit=opt
vietävästi	['PCLE_TYHMÄSTI']	clit=opt
vihaisesti	['PCLE_NOPEASTI']	clit=opt
vihamielisesti	['PCLE_NOPEASTI']	clit=opt
vihdoin	['PCLE_VALTAAN']	clit=opt
viheliäisesti	['PCLE_TYHMÄSTI']	clit=opt
vihkoittain	['PCLE_VALTAAN']	clit=opt
vihoissa	['PCLE_KOTONA']	poss=opt
vihoittain	['PCLE_VALTAAN']	clit=opt
viidesti	['PCLE_TYHMÄSTI']	clit=opt
viihteellisesti	['PCLE_TYHMÄSTI']	clit=opt
viihtyisästi	['PCLE_TYHMÄSTI']	clit=opt
viikoittain	['PCLE_VALTAAN']	clit=opt
viileästi	['PCLE_TYHMÄSTI']	clit=opt
viisaasti	['PCLE_NOPEASTI']	clit=opt
viistosti	['PCLE_NOPEASTI']	clit=opt
viitseliäästi	['PCLE_TYHMÄSTI']	clit=opt
viitteellisesti	['PCLE_TYHMÄSTI']	clit=opt
-viivaisesti	['PCLE_NOPEASTI']	clit=opt
viivasuorasti	['PCLE_NOPEASTI']	clit=opt
vikkelästi	['PCLE_TYHMÄSTI']	clit=opt
viktoriaanisesti	['PCLE_NOPEASTI']	clit=opt
vilkkaasti	['PCLE_NOPEASTI']	clit=opt
villisti	['PCLE_TYHMÄSTI']	clit=opt
vilpittömästi	['PCLE_TYHMÄSTI']	clit=opt
vilpoisasti	['PCLE_NOPEASTI']	clit=opt
vilpoisesti	['PCLE_NOPEASTI']	clit=opt
vimmaisesti	['PCLE_NOPEASTI']	clit=opt
vimmastuksissa	['PCLE_KOTONA']	poss=opt
vimmatusti	['PCLE_NOPEASTI']	clit=opt
vinhasti	['PCLE_NOPEASTI']	clit=opt
vinkeästi	['PCLE_TYHMÄSTI']	clit=opt
vinoittain	['PCLE_VALTAAN']	clit=opt
vinosti	['PCLE_NOPEASTI']	clit=opt
vinottain	['PCLE_VALTAAN']	clit=opt
virallisesti	['PCLE_NOPEASTI']	clit=opt
vireästi	['PCLE_TYHMÄSTI']	clit=opt
virheellisesti	['PCLE_TYHMÄSTI']	clit=opt
virkaintoisesti	['PCLE_NOPEASTI']	clit=opt
virkavaltaisesti	['PCLE_NOPEASTI']	clit=opt
virkeästi	['PCLE_TYHMÄSTI']	clit=opt
virolaisittain	['PCLE_VALTAAN']	clit=opt
vissisti	['PCLE_TYHMÄSTI']	clit=opt
visuaalisesti	['PCLE_NOPEASTI']	clit=opt
visusti	['PCLE_NOPEASTI']	clit=opt
vitaalisesti	['PCLE_NOPEASTI']	clit=opt
vitsikkäästi	['PCLE_TYHMÄSTI']	clit=opt
vittumaisesti	['PCLE_NOPEASTI']	clit=opt
viuhkamaisesti	['PCLE_NOPEASTI']	clit=opt
vivahteettomasti	['PCLE_NOPEASTI']	clit=opt
vivahteikkaasti	['PCLE_NOPEASTI']	clit=opt
-voimaisesti	['PCLE_NOPEASTI']	clit=opt
voimakkaasti	['PCLE_NOPEASTI']	clit=opt
voimallisesti	['PCLE_NOPEASTI']	clit=opt
voimaperäisesti	['PCLE_TYHMÄSTI']	clit=opt
voimattomasti	['PCLE_NOPEASTI']	clit=opt
voitokkaasti	['PCLE_NOPEASTI']	clit=opt
voitollisesti	['PCLE_NOPEASTI']	clit=opt
voitonriemuisesti	['PCLE_NOPEASTI']	clit=opt
voitonvarmasti	['PCLE_NOPEASTI']	clit=opt
voittoisasti	['PCLE_NOPEASTI']	clit=opt
-voittoisesti	['PCLE_NOPEASTI']	clit=opt
voittopuolisesti	['PCLE_NOPEASTI']	clit=opt
voivuksiin	['PCLE_VALTAAN']	poss=opt
voivuksissa	['PCLE_KOTONA']	poss=opt
vuodenajoittain	['PCLE_VALTAAN']	clit=opt
vuokseen	['PCLE_VALTAAN']	clit=opt
vuoksemme	['PCLE_ALLE']	clit=opt
vuokseni	['PCLE_VUOKSI']	clit=opt
vuoksenne	['PCLE_ALLE']	clit=opt
vuoksensa	['PCLE_KOTONA']	clit=opt
vuoksesi	['PCLE_VUOKSI']	clit=opt
vuoksi	['N_ONNI']	clit=opt
vuoksi	['N_ONNI']	poss=opt
vuoksi	['PCLE_VUOKSI']	clit=opt
vuoksi	['PCLE_VUOKSI']	poss=opt
vuolaasti	['PCLE_NOPEASTI']	clit=opt
vuolassanaisesti	['PCLE_NOPEASTI']	clit=opt
vuorenvarmasti	['PCLE_NOPEASTI']	clit=opt
vuoroittain	['PCLE_VALTAAN']	clit=opt
vuorokausittain	['PCLE_VALTAAN']	clit=opt
vuorovaikutteisesti	['PCLE_NOPEASTI']	clit=opt
vuosiluokittain	['PCLE_VALTAAN']	clit=opt
vuosineljänneksittäin	['PCLE_NÄKYVIIN']	clit=opt
vuosittain	['PCLE_VALTAAN']	clit=opt
vähittäin	['PCLE_NÄKYVIIN']	clit=opt
vähäeleisesti	['PCLE_TYHMÄSTI']	clit=opt
vähäilmeisesti	['PCLE_TYHMÄSTI']	clit=opt
vähälukuisesti	['PCLE_NOPEASTI']	clit=opt
väistyvästi	['PCLE_TYHMÄSTI']	clit=opt
väistämättömästi	['PCLE_TYHMÄSTI']	clit=opt
väkevästi	['PCLE_TYHMÄSTI']	clit=opt
väkinäisesti	['PCLE_TYHMÄSTI']	clit=opt
väkivallattomasti	['PCLE_NOPEASTI']	clit=opt
väkivaltaisesti	['PCLE_NOPEASTI']	clit=opt
väliaikaisesti	['PCLE_NOPEASTI']	clit=opt
välille	['PCLE_YLLE']	poss=opt
välillisesti	['PCLE_TYHMÄSTI']	clit=opt
välinpitämättömästi	['PCLE_TYHMÄSTI']	clit=opt
välissä	['PCLE_IKINÄ']	poss=opt
välistä	['PCLE_IKINÄ']	poss=opt
välitse	['PCLE_YLLE']	poss=opt
välittömästi	['PCLE_TYHMÄSTI']	clit=opt
väljästi	['PCLE_TYHMÄSTI']	clit=opt
välttämättömästi	['PCLE_TYHMÄSTI']	clit=opt
välähdyksittäin	['PCLE_NÄKYVIIN']	clit=opt
väläyksittäin	['PCLE_NÄKYVIIN']	clit=opt
värikkäästi	['PCLE_TYHMÄSTI']	clit=opt
värikylläisesti	['PCLE_TYHMÄSTI']	clit=opt
värittömästi	['PCLE_TYHMÄSTI']	clit=opt
väsyksiin	['PCLE_NÄKYVIIN']	poss=opt
väsyksissä	['PCLE_IKINÄ']	poss=opt
väsymättömästi	['PCLE_TYHMÄSTI']	clit=opt
väsyneesti	['PCLE_TYHMÄSTI']	clit=opt
vääjäämättömästi	['PCLE_TYHMÄSTI']	clit=opt
väärämielisesti	['PCLE_TYHMÄSTI']	clit=opt
yhdenmukaisesti	['PCLE_NOPEASTI']	clit=opt
yhdesti	['PCLE_TYHMÄSTI']	clit=opt
yhtaikaisesti	['PCLE_NOPEASTI']	clit=opt
yhteisesti	['PCLE_TYHMÄSTI']	clit=opt
yhteiskunnallisesti	['PCLE_NOPEASTI']	clit=opt
yhteisvastuisesti	['PCLE_NOPEASTI']	clit=opt
yhteisvastuullisesti	['PCLE_NOPEASTI']	clit=opt
yhtenäisesti	['PCLE_TYHMÄSTI']	clit=opt
yhtäaikaa	['PCLE_KOTONA']	clit=opt
yhtäaikaisesti	['PCLE_NOPEASTI']	clit=opt
yhtäjaksoisesti	['PCLE_NOPEASTI']	clit=opt
yhtäkkisesti	['PCLE_TYHMÄSTI']	clit=opt
yhtäläisesti	['PCLE_TYHMÄSTI']	clit=opt
yhtämittaisesti	['PCLE_NOPEASTI']	clit=opt
yhtäpitävästi	['PCLE_TYHMÄSTI']	clit=opt
yksiköittäin	['PCLE_NÄKYVIIN']	clit=opt
yksilöittäin	['PCLE_NÄKYVIIN']	clit=opt
yksilökeskeisesti	['PCLE_TYHMÄSTI']	clit=opt
yksilökohtaisesti	['PCLE_NOPEASTI']	clit=opt
yksilöllisesti	['PCLE_TYHMÄSTI']	clit=opt
yksimielisesti	['PCLE_TYHMÄSTI']	clit=opt
yksinkertaisesti	['PCLE_NOPEASTI']	clit=opt
yksinomaisesti	['PCLE_NOPEASTI']	clit=opt
yksinvaltaisesti	['PCLE_NOPEASTI']	clit=opt
yksinvaltiaasti	['PCLE_NOPEASTI']	clit=opt
yksioikoisesti	['PCLE_NOPEASTI']	clit=opt
yksipuolisesti	['PCLE_NOPEASTI']	clit=opt
yksiselitteisesti	['PCLE_TYHMÄSTI']	clit=opt
yksisilmäisesti	['PCLE_TYHMÄSTI']	clit=opt
yksitoikkoisesti	['PCLE_NOPEASTI']	clit=opt
yksitotisesti	['PCLE_NOPEASTI']	clit=opt
yksittäin	['PCLE_NÄKYVIIN']	clit=opt
yksittäisesti	['PCLE_TYHMÄSTI']	clit=opt
yksituumaisesti	['PCLE_NOPEASTI']	clit=opt
yksityisesti	['PCLE_TYHMÄSTI']	clit=opt
yksityiskohdittain	['PCLE_VALTAAN']	clit=opt
yksityiskohtaisesti	['PCLE_NOPEASTI']	clit=opt
yksivakaisesti	['PCLE_NOPEASTI']	clit=opt
yksiviivaisesti	['PCLE_NOPEASTI']	clit=opt
yleisesti	['PCLE_TYHMÄSTI']	clit=opt
yleismaailmallisesti	['PCLE_NOPEASTI']	clit=opt
yleispätevästi	['PCLE_TYHMÄSTI']	clit=opt
yleistajuisesti	['PCLE_NOPEASTI']	clit=opt
ylellisesti	['PCLE_TYHMÄSTI']	clit=opt
ylenkatseellisesti	['PCLE_NOPEASTI']	clit=opt
ylenpalttisesti	['PCLE_NOPEASTI']	clit=opt
ylettyville	['PCLE_YLLE']	poss=opt
ylettyvillä	['PCLE_IKINÄ']	poss=opt
ylettyviltä	['PCLE_IKINÄ']	poss=opt
ylettömästi	['PCLE_TYHMÄSTI']	clit=opt
ylhäisesti	['PCLE_TYHMÄSTI']	clit=opt
ylhäältäpäin	['PCLE_NÄKYVIIN']	clit=opt
yli-inhimillisesti	['PCLE_TYHMÄSTI']	clit=opt
yliluonnollisesti	['PCLE_NOPEASTI']	clit=opt
ylimaallisesti	['PCLE_NOPEASTI']	clit=opt
ylimalkaisesti	['PCLE_NOPEASTI']	clit=opt
ylimielisesti	['PCLE_TYHMÄSTI']	clit=opt
ylimuistoisesti	['PCLE_NOPEASTI']	clit=opt
ylimyksellisesti	['PCLE_TYHMÄSTI']	clit=opt
yliolkaisesti	['PCLE_NOPEASTI']	clit=opt
ylitse	['PCLE_YLLE']	poss=opt
ylivoimaisesti	['PCLE_NOPEASTI']	clit=opt
ylle	['PCLE_YLLE']	poss=opt
yllä	['PCLE_IKINÄ']	poss=opt
yllättävästi	['PCLE_TYHMÄSTI']	clit=opt
yllätyksellisesti	['PCLE_TYHMÄSTI']	clit=opt
ylpeästi	['PCLE_TYHMÄSTI']	clit=opt
yltiöpäisesti	['PCLE_TYHMÄSTI']	clit=opt
yltäkylläisesti	['PCLE_TYHMÄSTI']	clit=opt
yltä	['PCLE_IKINÄ']	poss=opt
ylväästi	['PCLE_TYHMÄSTI']	clit=opt
yläkanttiin	['PCLE_VALTAAN']	clit=opt
ymmälle	['PCLE_YLLE']	poss=opt
ymmällä	['PCLE_IKINÄ']	poss=opt
ymmärrettävästi	['PCLE_TYHMÄSTI']	clit=opt
ymmärtämättömästi	['PCLE_TYHMÄSTI']	clit=opt
ymmärtäväisesti	['PCLE_TYHMÄSTI']	clit=opt
ymmärtävästi	['PCLE_TYHMÄSTI']	clit=opt
ympärille	['PCLE_YLLE']	poss=opt
ympärillä	['PCLE_IKINÄ']	poss=opt
ympäriltä	['PCLE_IKINÄ']	poss=opt
ympäripyöreästi	['PCLE_TYHMÄSTI']	clit=opt
ynnä	['PCLE_IKINÄ']	clit=opt
ynseästi	['PCLE_TYHMÄSTI']	clit=opt
yritteliäästi	['PCLE_TYHMÄSTI']	clit=opt
yrmeästi	['PCLE_TYHMÄSTI']	clit=opt
ystävällisesti	['PCLE_TYHMÄSTI']	clit=opt
ystävällismielisesti	['PCLE_TYHMÄSTI']	clit=opt
ytimekkäästi	['PCLE_TYHMÄSTI']	clit=opt
äidillisesti	['PCLE_TYHMÄSTI']	clit=opt
äitelästi	['PCLE_TYHMÄSTI']	clit=opt
äkeästi	['PCLE_TYHMÄSTI']	clit=opt
äkikseltä	['PCLE_IKINÄ']	poss=opt
äkillisesti	['PCLE_TYHMÄSTI']	clit=opt
äkisti	['PCLE_TYHMÄSTI']	clit=opt
äkkijyrkästi	['PCLE_TYHMÄSTI']	clit=opt
äkkipikaisesti	['PCLE_NOPEASTI']	clit=opt
äkkiseltä	['PCLE_IKINÄ']	poss=opt
äksysti	['PCLE_TYHMÄSTI']	clit=opt
äkäisesti	['PCLE_TYHMÄSTI']	clit=opt
älyllisesti	['PCLE_TYHMÄSTI']	clit=opt
älyperäisesti	['PCLE_TYHMÄSTI']	clit=opt
älyttömästi	['PCLE_TYHMÄSTI']	clit=opt
ämpäreittäin	['PCLE_NÄKYVIIN']	clit=opt
äreästi	['PCLE_TYHMÄSTI']	clit=opt
ärhäkästi	['PCLE_TYHMÄSTI']	clit=opt
ärtyisästi	['PCLE_TYHMÄSTI']	clit=opt
äskettäin	['PCLE_NÄKYVIIN']	clit=opt
ääliömäisesti	['PCLE_TYHMÄSTI']	clit=opt
ääneen	['PCLE_NÄKYVIIN']	poss=opt
äänekkäästi	['PCLE_TYHMÄSTI']	clit=opt
äänenpitävästi	['PCLE_TYHMÄSTI']	clit=opt
äänettömästi	['PCLE_TYHMÄSTI']	clit=opt
-äänisesti	['PCLE_TYHMÄSTI']	clit=opt
ääressä	['PCLE_IKINÄ']	poss=opt
äärestä	['PCLE_IKINÄ']	poss=opt
äärettömästi	['PCLE_TYHMÄSTI']	clit=opt
ääriin	['PCLE_NÄKYVIIN']	clit=opt
öykkärimäisesti	['PCLE_TYHMÄSTI']	clit=opt
