aiempi	['A_AIEMPI']	subcat=Comp
alempi	['A_AIEMPI']	subcat=Comp
alin	['A_PAHIN']	subcat=Superl
biljardi	['NUM_MILJARDI']	subcat=cardinal
biljoona	['NUM_MILJOONA']	subcat=cardinal
biljoonasosa	['NUM_KOLMASOSA']	subcat=cardinal
dnro	['N_RUIPELO']	subcat=abbreviation
ensimmäinen	['NUM_ENSIMMÄINEN']	subcat=ordinal
Hki	['N_TYYLI']	subcat=abbreviation
hlö	['N_JÄÄTELÖ']	subcat=abbreviation
hra	['N_KIRJA']	subcat=abbreviation
hsto	['N_TALO']	subcat=abbreviation
jollainen	['A_AAKKOSELLINEN']	subcat=Relative
jonkinlainen	['A_AAKKOSELLINEN']	subcat=Quantor
kahdeksankymmentä	['NUM_KYMMENTÄ']	subcat=cardinal
kahdeksan	['NUM_KAHDEKSAN']	subcat=cardinal
kahdeksansataa	['NUM_KYMMENTÄ']	subcat=cardinal
kahdeksantoista	['NUM_KYMMENTÄ']	subcat=cardinal
kahdeksantoistasataa	['NUM_KYMMENTÄ']	subcat=cardinal
kahdeksantuhatta	['NUM_KYMMENTÄ']	subcat=cardinal
kahdeksaskymmenes	['NUM_NELJÄS']	subcat=ordinal
kahdeksas	['NUM_KOLMAS']	subcat=ordinal
kahdeksasosa	['NUM_KOLMASOSA']	subcat=cardinal
kahdeksassadas	['NUM_KOLMAS']	subcat=ordinal
kahdeksastoista	['NUM_KYMMENTÄ']	subcat=ordinal
kahdeksisenkymmentä	['NUM_KYMMENTÄ']	subcat=cardinal
kahdeksisen	['NUM_KUUTISEN']	subcat=cardinal
kahdeksisensataa	['NUM_KYMMENTÄ']	subcat=cardinal
kahdeksisentoista	['NUM_KYMMENTÄ']	subcat=cardinal
kahdeksisentuhatta	['NUM_KYMMENTÄ']	subcat=cardinal
kahdeskymmenesensimmäinen	['NUM_ENSIMMÄINEN']	subcat=ordinal
kahdeskymmeneskahdes	['NUM_KOLMAS']	subcat=ordinal
kahdeskymmenes	['NUM_NELJÄS']	subcat=ordinal
kahdeskymmenestoinen	['NUM_TOINEN']	subcat=ordinal
kahdeskymmenesyhdes	['NUM_NELJÄS']	subcat=ordinal
kahdes	['NUM_KOLMAS']	subcat=ordinal
kahdesosa	['NUM_KOLMASOSA']	subcat=cardinal
kahdessadas	['NUM_KOLMAS']	subcat=ordinal
kahdestoista	['NUM_KYMMENTÄ']	subcat=ordinal
kahta	['NUM_KYMMENTÄ']	subcat=cardinal
kahtisentoista	['NUM_KYMMENTÄ']	subcat=cardinal
kaksikymmentä	['NUM_KYMMENTÄ']	subcat=cardinal
kaksikymmentäyksi	['NUM_YKSI']	subcat=cardinal
kaksi	['NUM_KAKSI']	subcat=cardinal
kaksisataa	['NUM_KYMMENTÄ']	subcat=cardinal
kaksisentoista	['NUM_KYMMENTÄ']	subcat=cardinal
kaksitoista	['NUM_KYMMENTÄ']	subcat=cardinal
kaksituhatta	['NUM_KYMMENTÄ']	subcat=cardinal
kaks	['NUM_KYMMENTÄ']	subcat=cardinal
khra	['N_KIRJA']	subcat=abbreviation
kiljoona	['NUM_MILJOONA']	subcat=cardinal
klo	['N_TALO']	subcat=abbreviation
kni	['N_TYYLI']	subcat=abbreviation
kolmaskymmenes	['NUM_NELJÄS']	subcat=ordinal
kolmas	['NUM_KOLMAS']	subcat=ordinal
kolmasosa	['NUM_KOLMASOSA']	subcat=cardinal
kolmassadas	['NUM_KOLMAS']	subcat=ordinal
kolmastoista	['NUM_KYMMENTÄ']	subcat=ordinal
kolmekymmentä	['NUM_KYMMENTÄ']	subcat=cardinal
kolme	['NUM_KOLME']	subcat=cardinal
kolmesataa	['NUM_KYMMENTÄ']	subcat=cardinal
kolmetoista	['NUM_KYMMENTÄ']	subcat=cardinal
kolmetuhatta	['NUM_KYMMENTÄ']	subcat=cardinal
kolmisenkymmentä	['NUM_KYMMENTÄ']	subcat=cardinal
kolmisen	['NUM_KUUTISEN']	subcat=cardinal
kolmisensataa	['NUM_KYMMENTÄ']	subcat=cardinal
kolmisentoista	['NUM_KYMMENTÄ']	subcat=cardinal
kolmisentuhatta	['NUM_KYMMENTÄ']	subcat=cardinal
krnro	['N_RUIPELO']	subcat=abbreviation
kuudeskymmenes	['NUM_NELJÄS']	subcat=ordinal
kuudes	['NUM_KOLMAS']	subcat=ordinal
kuudesosa	['NUM_KOLMASOSA']	subcat=cardinal
kuudessadas	['NUM_KOLMAS']	subcat=ordinal
kuudestoista	['NUM_KYMMENTÄ']	subcat=ordinal
kuusikymmentä	['NUM_KYMMENTÄ']	subcat=cardinal
kuusi	['NUM_KUUSI']	subcat=cardinal
kuusisataa	['NUM_KYMMENTÄ']	subcat=cardinal
kuusitoista	['NUM_KYMMENTÄ']	subcat=cardinal
kuutisenkymmentä	['NUM_KYMMENTÄ']	subcat=cardinal
kuutisen	['NUM_KUUTISEN']	subcat=cardinal
kuutisensataa	['NUM_KYMMENTÄ']	subcat=cardinal
kuutisentoista	['NUM_KYMMENTÄ']	subcat=cardinal
kuutisentuhatta	['NUM_KYMMENTÄ']	subcat=cardinal
kvadriljoona	['NUM_MILJOONA']	subcat=cardinal
kvintiljoona	['NUM_MILJOONA']	subcat=cardinal
kymmenen	['NUM_KYMMENEN']	subcat=cardinal
kymmenentuhatta	['NUM_KYMMENTÄ']	subcat=cardinal
kymmenes	['NUM_NELJÄS']	subcat=ordinal
kymmenesosa	['NUM_KOLMASOSA']	subcat=cardinal
kymmenestuhannesosa	['NUM_KOLMASOSA']	subcat=cardinal
kymmenisen	['NUM_VIITISEN']	subcat=cardinal
kymmenisentuhatta	['NUM_KYMMENTÄ']	subcat=cardinal
kymmenkunta	['NUM_KYMMENKUNTA']	subcat=cardinal
kymmen	['NUM_KYMMEN']	subcat=cardinal
lähempi	['A_LÄHEMPI']	subcat=Comp
lähin	['A_SISIN']	subcat=Superl
miljardi	['NUM_MILJARDI']	subcat=cardinal
miljardisosa	['NUM_KOLMASOSA']	subcat=cardinal
miljoona	['NUM_MILJOONA']	subcat=cardinal
miljoonasosa	['NUM_KOLMASOSA']	subcat=cardinal
millainen	['A_AAKKOSELLINEN']	subcat=Interrogative
millainen	['A_AAKKOSELLINEN']	subcat=Quantor
mimmoinen	['A_AAKKOSELLINEN']	subcat=Interrogative
minkälainen	['A_AAKKOSELLINEN']	subcat=Interrogative
minkäslainen	['A_AAKKOSELLINEN']	subcat=Interrogative
minkäänlainen	['A_AAKKOSELLINEN']	subcat=Interrogative
nelisenkymmentä	['NUM_KYMMENTÄ']	subcat=cardinal
nelisen	['NUM_VIITISEN']	subcat=cardinal
nelisensataa	['NUM_KYMMENTÄ']	subcat=cardinal
nelisentoista	['NUM_KYMMENTÄ']	subcat=cardinal
nelisentuhatta	['NUM_KYMMENTÄ']	subcat=cardinal
neljäkymmentä	['NUM_KYMMENTÄ']	subcat=cardinal
neljä	['NUM_NELJÄ']	subcat=cardinal
neljäsataa	['NUM_KYMMENTÄ']	subcat=cardinal
neljäskymmenes	['NUM_NELJÄS']	subcat=ordinal
neljäs	['NUM_NELJÄS']	subcat=ordinal
neljäsosa	['NUM_KOLMASOSA']	subcat=cardinal
neljässadas	['NUM_KOLMAS']	subcat=ordinal
neljästoista	['NUM_KYMMENTÄ']	subcat=ordinal
neljätoista	['NUM_KYMMENTÄ']	subcat=cardinal
neljätuhatta	['NUM_KYMMENTÄ']	subcat=cardinal
nolla	['NUM_MILJOONA']	subcat=cardinal
nollas	['NUM_KOLMAS']	subcat=ordinal
n:o	['N_RUIPELO']	subcat=abbreviation
nro	['N_RUIPELO']	subcat=abbreviation
nro	['PCLE_VAAN']	subcat=abbreviation
paras	['A_PARAS']	subcat=Superl
parempi	['A_AIEMPI']	subcat=Comp
parhain	['A_PAHIN']	subcat=Superl
parikymmentä	['NUM_KYMMENTÄ']	subcat=cardinal
pari	['NUM_PARI']	subcat=cardinal
parisataa	['NUM_KYMMENTÄ']	subcat=cardinal
parisenkymmentä	['NUM_KYMMENTÄ']	subcat=cardinal
parisen	['NUM_KUUTISEN']	subcat=cardinal
parisensataa	['NUM_KYMMENTÄ']	subcat=cardinal
parituhatta	['NUM_KYMMENTÄ']	subcat=cardinal
pjsto	['N_TALO']	subcat=abbreviation
psto	['N_TALO']	subcat=abbreviation
ptri	['N_KEHVELI']	subcat=abbreviation
puolenkymmentä	['NUM_KYMMENTÄ']	subcat=cardinal
puolensataa	['NUM_KYMMENTÄ']	subcat=cardinal
puolentuhatta	['NUM_KYMMENTÄ']	subcat=cardinal
puolikymmentä	['NUM_KYMMENTÄ']	subcat=cardinal
puoli	['NUM_PUOLI']	subcat=cardinal
puolisataa	['NUM_KYMMENTÄ']	subcat=cardinal
puolisenkymmentä	['NUM_KYMMENTÄ']	subcat=cardinal
puolisen	['NUM_KUUTISEN']	subcat=cardinal
puolisensataa	['NUM_KYMMENTÄ']	subcat=cardinal
puolisentoista	['NUM_KYMMENTÄ']	subcat=cardinal
puolisentoistasataa	['NUM_KYMMENTÄ']	subcat=cardinal
puolitoistakymmentä	['NUM_KYMMENTÄ']	subcat=cardinal
puolitoista	['NUM_KYMMENTÄ']	subcat=cardinal
puolitoistasataa	['NUM_KYMMENTÄ']	subcat=cardinal
puolituhatta	['NUM_KYMMENTÄ']	subcat=cardinal
RN:o	['N_RUIPELO']	subcat=abbreviation
rva	['N_SOITTAJA']	subcat=abbreviation
sadas	['NUM_KOLMAS']	subcat=ordinal
sadasosa	['NUM_KOLMASOSA']	subcat=cardinal
sadastuhannesosa	['NUM_KOLMASOSA']	subcat=cardinal
samanlainen	['A_AAKKOSELLINEN']	subcat=Quantor
satakunta	['NUM_KYMMENKUNTA']	subcat=cardinal
sata	['NUM_SATA']	subcat=cardinal
satatuhatta	['NUM_KYMMENTÄ']	subcat=cardinal
seitsemisenkymmentä	['NUM_KYMMENTÄ']	subcat=cardinal
seitsemisen	['NUM_VIITISEN']	subcat=cardinal
seitsemisensataa	['NUM_KYMMENTÄ']	subcat=cardinal
seitsemisentoista	['NUM_KYMMENTÄ']	subcat=cardinal
seitsemisentuhatta	['NUM_KYMMENTÄ']	subcat=cardinal
seitsemänkymmentä	['NUM_KYMMENTÄ']	subcat=cardinal
seitsemän	['NUM_YHDEKSÄN']	subcat=cardinal
seitsemänsataa	['NUM_KYMMENTÄ']	subcat=cardinal
seitsemäntoista	['NUM_KYMMENTÄ']	subcat=cardinal
seitsemäntuhatta	['NUM_KYMMENTÄ']	subcat=cardinal
seitsemäskymmenes	['NUM_NELJÄS']	subcat=ordinal
seitsemäs	['NUM_NELJÄS']	subcat=ordinal
seitsemäsosa	['NUM_KOLMASOSA']	subcat=cardinal
seitsemässadas	['NUM_KOLMAS']	subcat=ordinal
seitsemästoista	['NUM_KYMMENTÄ']	subcat=ordinal
sellainen	['A_AAKKOSELLINEN']	subcat=Demonstrative
semmoinen	['A_AAKKOSELLINEN']	subcat=Demonstrative
semmonen	['A_AAKKOSELLINEN']	subcat=Demonstrative
snro	['N_RUIPELO']	subcat=abbreviation
srnro	['N_RUIPELO']	subcat=abbreviation
Tku	['N_ASU']	subcat=abbreviation
toinen	['NUM_TOINEN']	subcat=ordinal
toistakymmentä	['NUM_KYMMENTÄ']	subcat=cardinal
toistakymmentätuhatta	['NUM_KYMMENTÄ']	subcat=cardinal
toistasataa	['NUM_KYMMENTÄ']	subcat=cardinal
toistatuhatta	['NUM_KYMMENTÄ']	subcat=cardinal
tommonen	['A_AAKKOSELLINEN']	subcat=Demonstrative
Tre	['N_PISTE']	subcat=abbreviation
triljoona	['NUM_MILJOONA']	subcat=cardinal
triljoonasosa	['NUM_KOLMASOSA']	subcat=cardinal
tri	['N_TYYLI']	subcat=abbreviation
tsto	['N_TALO']	subcat=abbreviation
tuhannes	['NUM_KOLMAS']	subcat=ordinal
tuhannesosa	['NUM_KOLMASOSA']	subcat=cardinal
tuhantisen	['NUM_KUUTISEN']	subcat=cardinal
tuhatkunta	['NUM_KYMMENKUNTA']	subcat=cardinal
tuhat	['NUM_TUHAT']	subcat=cardinal
tuollainen	['A_AAKKOSELLINEN']	subcat=Demonstrative
tuolloinen	['A_AAKKOSELLINEN']	subcat=Demonstrative
tuommoinen	['A_AAKKOSELLINEN']	subcat=Demonstrative
tällainen	['A_AAKKOSELLINEN']	subcat=Demonstrative
tämmöinen	['A_KYLMÄJÄRKINEN']	subcat=Demonstrative
uloin	['A_PAHIN']	subcat=Superl
ulompi	['A_AIEMPI']	subcat=Comp
viideskymmenes	['NUM_NELJÄS']	subcat=ordinal
viides	['NUM_NELJÄS']	subcat=ordinal
viidesosa	['NUM_KOLMASOSA']	subcat=cardinal
viidessadas	['NUM_KOLMAS']	subcat=ordinal
viidestoista	['NUM_KYMMENTÄ']	subcat=ordinal
viisikymmentä	['NUM_KYMMENTÄ']	subcat=cardinal
viisi	['NUM_VIISI']	subcat=cardinal
viisisataa	['NUM_KYMMENTÄ']	subcat=cardinal
viisitoista	['NUM_KYMMENTÄ']	subcat=cardinal
viisituhatta	['NUM_KYMMENTÄ']	subcat=cardinal
viitisenkymmentä	['NUM_KYMMENTÄ']	subcat=cardinal
viitisen	['NUM_VIITISEN']	subcat=cardinal
viitisensataa	['NUM_KYMMENTÄ']	subcat=cardinal
viitisentoista	['NUM_KYMMENTÄ']	subcat=cardinal
viitisentuhatta	['NUM_KYMMENTÄ']	subcat=cardinal
yhdeksisenkymmentä	['NUM_KYMMENTÄ']	subcat=cardinal
yhdeksisen	['NUM_VIITISEN']	subcat=cardinal
yhdeksisensataa	['NUM_KYMMENTÄ']	subcat=cardinal
yhdeksisentoista	['NUM_KYMMENTÄ']	subcat=cardinal
yhdeksisentuhatta	['NUM_KYMMENTÄ']	subcat=cardinal
yhdeksänkymmentä	['NUM_KYMMENTÄ']	subcat=cardinal
yhdeksän	['NUM_YHDEKSÄN']	subcat=cardinal
yhdeksänsataa	['NUM_KYMMENTÄ']	subcat=cardinal
yhdeksäntoista	['NUM_KYMMENTÄ']	subcat=cardinal
yhdeksäntoistasataa	['NUM_KYMMENTÄ']	subcat=cardinal
yhdeksäntuhatta	['NUM_KYMMENTÄ']	subcat=cardinal
yhdeksäskymmenes	['NUM_NELJÄS']	subcat=ordinal
yhdeksäs	['NUM_NELJÄS']	subcat=ordinal
yhdeksäsosa	['NUM_KOLMASOSA']	subcat=cardinal
yhdeksässadas	['NUM_KOLMAS']	subcat=ordinal
yhdeksästoista	['NUM_KYMMENTÄ']	subcat=ordinal
yhdes	['NUM_NELJÄS']	subcat=ordinal
yhdestoista	['NUM_KYMMENTÄ']	subcat=ordinal
yhtisentoista	['NUM_KYMMENTÄ']	subcat=cardinal
yhtä	['NUM_KYMMENTÄ']	subcat=cardinal
yksi	['NUM_YKSI']	subcat=cardinal
yksisentoista	['NUM_KYMMENTÄ']	subcat=cardinal
yksitoista	['NUM_KYMMENTÄ']	subcat=cardinal
yks	['NUM_KYMMENTÄ']	subcat=cardinal
ylempi	['A_LÄHEMPI']	subcat=Comp
ylin	['A_SISIN']	subcat=Superl
yrnro	['N_RUIPELO']	subcat=abbreviation
