new_para	deletion
A_AAKKOSELLINEN	nen
A_AAVA	a
A_ABNORMAALI	i
A_ABNORMI	i
A_AHNE	
A_AIEMPI	pi
A_AINOA	a
A_AINUT	t
A_ALASTON	n
A_AUTIO	
A_AUTUAS	s
A_AVOIN	n
A_BEIGE	
A_EHTA	ta
A_EHYT	t
A_GAY	
A_HAILAKKA	ka
A_HALPA	pa
A_HAPAN	an
A_HAPERA	a
A_HARMAJA	a
A_HARRAS	ras
A_HELLE	le
A_HIDAS	das
A_HOIKKA	ka
A_HUPAKKO	ko
A_HURTTI	ti
A_HÄPÄISTY	
A_HÖLÖ	
A_HÖMPPÄ	pä
A_HÖPPÄNÄ	ä
A_IKÄLOPPU	pu
A_JÄREÄ	ä
A_KADE	de
A_KELPO	po
A_KOHELO	
A_KOLKKO	ko
A_KORKEA	a
A_KULTA	ta
A_KULUNUT	ut
A_KYLMÄJÄRKINEN	nen
A_KYVYTÖN	ön
A_KYYTTÖ	tö
A_KÄYPÄ	pä
A_KÖKKÖ	kö
A_LAKO	ko
A_LATUSKA	a
A_LENKO	ko
A_LÄHEMPI	pi
A_LÄHTEISYYS	s
A_LÄMMIN	min
A_LÄNTÄ	tä
A_LÄTYSKÄ	ä
A_LÖPERÖ	
A_LÖRPPÖ	pö
A_MARTO	to
A_MATALA	a
A_MATTA	ta
A_MELTO	to
A_MENTY	ty
A_MIETO	to
A_MUU	u
A_MYKKÄ	kä
A_MÄRKÄ	kä
A_MÄTÄ	tä
A_OHUT	t
A_OIKEE	e
A_OPAAKKI	ki
A_PAHIN	n
A_PANTU	tu
A_PARANNELTU	tu
A_PARAS	as
A_PEEAA	a
A_PIENI	i
A_PIERTY	ty
A_PINKKI	ki
A_PITKÄ	tkä
A_POHATTA	ta
A_POPPA	pa
A_PURTU	tu
A_RAAKA	ka
A_RAITIS	is
A_RAMPA	pa
A_REHTI	ti
A_REIPAS	as
A_RIETAS	as
A_RIIVIÖ	
A_RUMA	a
A_RÄVÄKKÄ	kä
A_SANKA	ka
A_SIPPI	pi
A_SISIN	n
A_STYDI	i
A_SUIPPO	po
A_SUOLISTETTAVA	a
A_SUURI	i
A_SYMPPIS	s
A_SYYPÄÄ	ä
A_SÄIKKY	ky
A_SÄKKÄRÄ	ä
A_TARKKA	ka
A_TERVE	
A_TERÄVÄ	ä
A_TIIVIS	is
A_TOOPE	
A_TUHTI	ti
A_TUMMAHKO	
A_TURTA	ta
A_TYHMÄ	ä
A_TYVEN	
A_TYYLIKÄS	äs
A_TYÖLLISTETTÄVÄ	ä
A_TYÖLÄS	s
A_TÄYSI	si
A_UUSI	si
A_VALKAISTU	
A_VALMIS	is
A_VAPAA	a
A_VASEN	n
A_VELTTO	to
A_VENTO	to
A_VIATON	on
A_VIHANTA	ta
A_VIIPALOITU	tu
A_VIMMATTU	tu
A_VIRKKU	ku
A_VOIMAKAS	as
A_VOIPA	pa
A_VÄHÄTELTY	ty
A_VÄNKÄ	kä
A_VÄÄRTTI	ti
A_YKSILÖITY	ty
A_YLENNETTY	ty
A_ÄLLISTYNYT	yt
A_ÖYKKÄRI	i
N_AAKKOSELLISUUS	s
N_AAKKOSTAMINEN	nen
N_AALLOT	lot
N_AAMUKAHDEKSAN	an
N_AAMUKOLME	e
N_AAMUKYMMENEN	en
N_AAMUYHDEKSÄN	än
N_AAMUYKSI	ksi
N_AARRE	re
N_AHDET	det
N_AIKA	ika
N_AIVOKUOLLUT	ut
N_AIVOT	t
N_AJATAR	ar
N_ALKEET	keet
N_ALKU	ku
N_ALLAS	las
N_ALTIS	is
N_ANTIMET	timet
N_APE	e
N_APU	pu
N_ARISTOTELES	s
N_ARKI	ki
N_ASEMA	a
N_ASKAR	
N_ASKELLIN	lin
N_ASTE	
N_ASU	
N_ASUKAS	as
N_ATERIMET	met
N_AUER	er
N_BÉBÉ	
N_BEIGNET	
N_BERNIE	
N_BESSERWISSER	
N_BIDEE	e
N_BIKINIT	t
N_BORDEAUX	
N_BRASSERIE	
N_BRIE	
N_BÄNET	t
N_CAMUS	
N_CHACHACHA	
N_COMPOUND	
N_COWBOY	
N_DIMITRIS	s
N_EKKE	ke
N_ELIN	n
N_ELÄMÄ	ä
N_EPÄILTY	ty
N_ESQUIMAU	
N_EUGENE	
N_FARKUT	ut
N_FARMARIT	it
N_FIFA	
N_FONDUE	
N_FONDYY	y
N_FÄNRIKIT	it
N_GAY	
N_HAAKSI	ksi
N_HAI	i
N_HAIT	it
N_HAMMAS	mas
N_HAPAN	an
N_HAPPI	pi
N_HAPPO	po
N_HAPSI	psi
N_HARMAAT	at
N_HEITIN	in
N_HENKI	ki
N_HEPO	po
N_HIIRI	i
N_HIPAT	at
N_HIRTTO	to
N_HIUTALEET	et
N_HOKSOTTIMET	et
N_HONKA	ka
N_HOPEAT	at
N_HORTA	ta
N_HOUSUT	t
N_HUOLITELTU	tu
N_HUPI	pi
N_HYLJE	je
N_HYLKY	ky
N_HYNTTEET	teet
N_HYNTTYYT	tyyt
N_HYÖTYY	y
N_HÄIRIÖ	
N_HÄKKI	ki
N_HÄKKYRÄ	ä
N_HÄMET	t
N_HÄMMINKI	ki
N_HÄNNÄT	ät
N_HÄNTÄ	tä
N_HÄRKIN	n
N_HÄVINNEET	et
N_HÄÄT	ät
N_HÄÄTÖ	tö
N_HÖLKKÄ	kä
N_HÖPÖTTÄJÄ	ä
N_HÖYHENET	et
N_IEN	en
N_IES	es
N_IKENET	kenet
N_IMMYT	myt
N_INGET	get
N_ITÄMAAT	at
N_JEPPE	pe
N_JOCKEY	
N_JOUKOT	ot
N_JOUTSEN	
N_JUHLAT	at
N_JUMALA	a
N_JUOVAT	vat
N_JYLKYT	yt
N_JÄLSI	si
N_JÄRJESTÖT	t
N_JÄRKI	ki
N_JÄRVITAHDON	don
N_JÄÄTELÖ	
N_KAARET	et
N_KAARRET	ret
N_KAARROT	rot
N_KALATOIN	oin
N_KAMPPEET	peet
N_KANAALI	i
N_KANGASALA	a
N_KANGAS	gas
N_KANKAHAT	hat
N_KANNEL	nel
N_KANNET	net
N_KARRAT	rat
N_KASTANJETIT	it
N_KASTIKE	e
N_KASTILJAT	at
N_KAUSI	si
N_KEHVELI	i
N_KELTIS	is
N_KENGÄT	gät
N_KENKÄ	kä
N_KENTTÄ	tä
N_KENTÄT	ät
N_KERITSIMET	met
N_KERROIN	roin
N_KERTA	ta
N_KEVÄT	t
N_KIDE	de
N_KIELTO	to
N_KIERRE	re
N_KIERRIN	rin
N_KIHARAT	t
N_KIHARRIN	rin
N_KIINNE	ne
N_KIIRU	
N_KILPIKKÄÄT	käät
N_KILPI	pi
N_KINNAS	nas
N_KINNER	ner
N_KIRITTÄRET	täret
N_KIRJA	a
N_KIRVES	s
N_KITARA	a
N_KIVI	i
N_KLUMPIT	it
N_KOE	e
N_KOKO	ko
N_KOMPA	pa
N_KORPI	pi
N_KORTES	es
N_KORTET	et
N_KORTTI	ti
N_KORVET	vet
N_KOUVOT	t
N_KREUS	s
N_KUITU	tu
N_KUMMUT	mut
N_KUNGFU	
N_KUNNAT	nat
N_KUNTA	ta
N_KUOPAT	at
N_KUOPPA	pa
N_KUPPI	pi
N_KUTSUNTA	ta
N_KUULOKKEET	keet
N_KUUS	s
N_KYDÖT	döt
N_KYKY	ky
N_KYLKIÄINEN	nen
N_KYLÄNVANHIN	n
N_KYNNET	net
N_KYNNÄÄT	ät
N_KYSYNTÄ	tä
N_KYYNEL	
N_KÄKI	ki
N_KÄMMEKKÄ	kä
N_KÄPY	py
N_KÄPÄLÄ	ä
N_KÄRJET	jet
N_KÄRRY	
N_KÄRSÄKÄS	äs
N_KÄRÄJÄT	t
N_KÄSITE	e
N_KÄÄDYT	dyt
N_KÄÄNNIN	nin
N_KÄÄNTÖ	tö
N_KÖNGÄS	gäs
N_KÖYHYYS	s
N_KÖYSI	si
N_KÖÖ	ö
N_LAET	et
N_LAHDET	det
N_LAHTI	ti
N_LAIDUN	dun
N_LAKI	ki
N_LAMMET	met
N_LAMMI	pi
N_LAMMIT	mit
N_LANKA	ka
N_LANNET	net
N_LAPSI	psi
N_LASIT	t
N_LEHDET	det
N_LEHTI	ti
N_LEIKKUU	u
N_LEIPÄ	pä
N_LENTTEE	e
N_LEPAKKO	ko
N_LIEMI	mi
N_LIITTOUTUNEET	et
N_LIIVIT	t
N_LINGOT	got
N_LINTU	tu
N_LIPEÄ	ä
N_LIPOTTARET	taret
N_LIPPU	pu
N_LIUKU	ku
N_LIVVADIEVÁT	t
N_LOKA	ka
N_LOKKI	ki
N_LOMMOL	mol
N_LOTTE	te
N_LOUET	et
N_LUHDAT	dat
N_LUKU	ku
N_LUMME	me
N_LUODE	de
N_LUODES	des
N_LUOKKA	ka
N_LUOLIKOT	ot
N_LUPA	pa
N_LUSIKKA	ka
N_LÄHDES	des
N_LÄHDET	det
N_LÄHIN	n
N_LÄMMIN	min
N_LÄMPÖ	pö
N_LÄNGET	get
N_LÄNSI	si
N_LÄÄKE	e
N_LÖPÖ	pö
N_MAA	a
N_MAKKARA	a
N_MAKU	ku
N_MALKO	ko
N_MALMÖ	
N_MALTAAT	taat
N_MANNER	ner
N_MARKKINAT	t
N_MATEE	e
N_MATKUET	et
N_MERI	i
N_MERTU	tu
N_METTE	te
N_MIEHET	het
N_MIELENGE	ge
N_MIELLE	le
N_MIES	s
N_MILJÖÖT	öt
N_MILJÖÖ	ö
N_MITTA	ta
N_MONSIEUR	
N_MULTA	ta
N_MURTEET	teet
N_MUUNNIN	nin
N_MYRKKY	ky
N_MÄET	et
N_MÄNNYT	nyt
N_MÄNTY	ty
N_MÄTTÄÄT	täät
N_MÄTÄS	äs
N_MÖMMÖ	
N_MÖRKÖ	kö
N_NALLE	
N_NEITSYT	t
N_NEUVOTTELUT	t
N_NIEMET	t
N_NIHTI	ti
N_NIITUT	ut
N_NIITYT	yt
N_NIMETÖIN	töin
N_NIMETÖN	tön
N_NISSE	
N_NOKI	ki
N_NOUGAT	
N_NUGAA	a
N_NUKKE	ke
N_NYLJIN	jin
N_NÄKY	ky
N_NÄKÖ	kö
N_NÄLKÄ	kä
N_OIKEUDET	det
N_OLKA	ka
N_OLUT	t
N_OMMEL	mel
N_ONKI	ki
N_ONNET	et
N_ONNI	i
N_OOKOO	o
N_OPINNOT	not
N_ORI	i
N_OSATON	ton
N_OSOITE	e
N_PAIKAT	at
N_PANKIT	it
N_PARFAIT	
N_PATA	ta
N_PATEE	e
N_PATSAS	s
N_PEIPOT	ot
N_PELKO	ko
N_PELTI	ti
N_PENGER	ger
N_PERKEET	keet
N_PIDOT	dot
N_PIENNAR	nar
N_PIHDIT	dit
N_PII	i
N_PIIROA	a
N_PINSETIT	it
N_PIPPALOT	t
N_PISTE	
N_POHATTA	ta
N_POHJE	je
N_POIKA	ika
N_POIUT	ut
N_POJAT	jat
N_POLITIIKKA	ka
N_POLJIN	jin
N_PONSI	si
N_PORRAS	ras
N_PORTAAT	taat
N_PROBLEEMA	a
N_PUHELIN	n
N_PUIN	in
N_PUKIMET	met
N_PUNK	
N_PUUT	ut
N_PUU	u
N_PYHTÄÄ	ä
N_PYTTY	ty
N_PYYHE	e
N_PYYHIN	in
N_PYYT	yt
N_PYY	y
N_PÄÄ	ä
N_PÖKSYT	t
N_PÖLHÄÄT	ät
N_PÖLLÖT	t
N_PÖNTTÖ	tö
N_PÖYTÄ	tä
N_RAAVIN	vin
N_RAGUU	u
N_RAKENNE	ne
N_RAMPA	pa
N_RANGAT	gat
N_RANNAT	nat
N_RAPPE	pe
N_RAPPUSET	set
N_RAPUT	ut
N_RATAS	as
N_RATTAAT	taat
N_RAUDAT	dat
N_RAUNIOT	t
N_RAVET	t
N_RAVUT	vut
N_REGGAE	
N_REIKÄ	kä
N_REIÄT	ät
N_RENKAAT	kaat
N_RIIPI	pi
N_RIIVET	vet
N_RIMMI	pi
N_RIMMIT	mit
N_RIMPI	pi
N_RINNET	net
N_RINTEET	teet
N_RIPE	e
N_RIPSET	et
N_RIUTAT	at
N_ROHTIMET	timet
N_ROITOT	ot
N_ROMPAAT	paat
N_ROSÉ	
N_ROTAT	at
N_ROTTA	ta
N_RUIPELO	
N_RUIS	is
N_RUMPU	pu
N_RUNKO	ko
N_RUOKA	oka
N_RUOKO	ko
N_RUOPPAAT	paat
N_RUUHI	i
N_RUUMIS	s
N_RUUVI	i
N_RYNNÄS	näs
N_RYNTTYYT	tyyt
N_RYNTÄÄT	täät
N_RYPÄS	äs
N_RYYPPY	py
N_RÄJÄYTYS	s
N_RÄMEET	et
N_RÄMEÄT	ät
N_RÄMIÄT	ät
N_SAAPAS	as
N_SAARET	et
N_SAKSET	et
N_SALONTEET	teet
N_SALPA	pa
N_SAMMALET	et
N_SAMPI	pi
N_SAMPO	po
N_SANKARI	i
N_SEIKKAILU	
N_SEIVÄS	väs
N_SELENE	
N_SELJÄT	jät
N_SEPPÄ	pä
N_SERGEJ	
N_SERKUKSET	kset
N_SHOW	
N_SIEMEN	
N_SIIRTO	to
N_SIIVILÄ	ä
N_SILAKAT	at
N_SILMÄKKEET	keet
N_SISÄLTÖ	tö
N_SIUNAAMATTOMAT	tomat
N_SIVELLIN	lin
N_SIVISTYNYT	yt
N_SKEITTI	ti
N_SOINTI	ti
N_SOKEA	a
N_SOTA	ta
N_SPOTIFY	
N_STADION	
N_SUHTEET	teet
N_SUKAT	at
N_SULKA	ka
N_SUODATIN	in
N_SUOT	uot
N_SYDÄN	n
N_SYLI	i
N_SYLTÄ	tä
N_SYNNYTTIMET	timet
N_SYÖMINGIT	git
N_SÄEN	en
N_SÄNKY	ky
N_SÄRKÄT	ät
N_SÄRVIN	vin
N_SÄÄDIN	din
N_SÄÄNNÖT	nöt
N_SÄÄRET	et
N_TAIMI	mi
N_TAIVAL	val
N_TALKOOT	ot
N_TALO	
N_TANHUA	a
N_TARPEET	peet
N_TARVE	ve
N_TAUDIT	dit
N_TAUTI	ti
N_TAVAT	vat
N_TEE	e
N_TEHDAS	das
N_TEHTAAT	taat
N_TEKO	ko
N_TIE	ie
N_TIENOO	o
N_TIETEET	teet
N_TIET	iet
N_TIHVII	i
N_TIKKAAT	kaat
N_TIKKU	ku
N_TIPPA	pa
N_TOIMET	et
N_TOKEE	e
N_TONGIT	git
N_TORTTU	tu
N_TOULAT	at
N_TRIKOO	o
N_TULI	i
N_TUNNIT	nit
N_TUNTO	to
N_TUOMIO	
N_TYPPI	pi
N_TYTÄR	är
N_TYTÖT	öt
N_TYYLI	i
N_TYYPPI	pi
N_TYÖTTÖMÄT	tömät
N_TYÖT	yöt
N_TYÖ	yö
N_TÖLPÄKÖT	öt
N_TÖLPÄT	ät
N_TÖRPPÖ	pö
N_UDAR	dar
N_UKKO	ko
N_UKSI	ksi
N_ULAPPA	pa
N_UROS	s
N_VAADIN	din
N_VAAKA	ka
N_VAANII	i
N_VAASAN	
N_VAATTEET	teet
N_VAINAA	a
N_VAKUUTUS	s
N_VALJAAT	at
N_VALLAT	at
N_VALTA	ta
N_VANHEMMAT	mat
N_VANHEMPI	pi
N_VANKI	ki
N_VANTUS	us
N_VARAS	as
N_VARAT	at
N_VARPAAT	paat
N_VARSI	si
N_VARVAS	vas
N_VASEN	n
N_VEHKEILY	
N_VEITSI	tsi
N_VELI	i
N_VELJET	jet
N_VEMMEL	mel
N_VERI	i
N_VERSAILLES	
N_VETIMET	timet
N_VETO	to
N_VETY	ty
N_VIENTI	ti
N_VIHKIÄISET	set
N_VIIRRET	ret
N_VIIS	s
N_VIIVE	ve
N_VIKA	ka
N_VINKU	ku
N_VIRRET	ret
N_VIRSI	si
N_VODĂ	ă
N_VOIMA	a
N_VUODET	det
N_VUOLLE	le
N_VUOLLET	let
N_VUOSITUHAT	t
N_VUO	uo
N_VÄRTÖ	tö
N_YHTIÖT	t
N_YKSIKKÖ	kö
N_YLKÄ	kä
N_YLÄNKÖ	kö
N_YLÖÖ	ö
N_YMPÄRYSTÄ	ä
N_YRITTÄ	tä
N_YSTÄVYKSET	kset
N_YÖKKÖ	kö
N_ZEN	
N_ZOMBIE	
N_ÄYRÄS	s
V_AALLOTA	lota
V_AHNEHTIA	tia
V_AMPUA	pua
V_ARVAILLA	illa
V_ARVATA	ta
V_AUTTAA	taa
V_DIGATA	ata
V_EHTIÄ	tiä
V_EI	ei
V_ENTÄÄ	tää
V_ERATA	ata
V_ETUILLA	la
V_HALAJAA	ta
V_HALJETA	jeta
V_HAPATA	ata
V_HARPPOA	poa
V_HAUKKOA	koa
V_HELLITÄ	litä
V_HELPOTA	ota
V_HELÄJÄÄ	ää
V_HERMOTTUA	tua
V_HERÄTELLÄ	ellä
V_HIIPUA	pua
V_HIVENTÄÄ	tää
V_HUMALTUA	tua
V_HUONONTAA	taa
V_HUUTAA	taa
V_HYLJÄTÄ	jätä
V_HYLKIÄ	kiä
V_HYPELLÄ	ellä
V_HYPPIÄ	piä
V_HÄVÄISTÄ	väistä
V_ILJETÄ	jetä
V_INNOTA	nota
V_IRROTA	rota
V_ISÄNNÖIDÄ	idä
V_JAHDATA	data
V_JOUTAA	taa
V_JUOSTA	sta
V_JYRKETÄ	etä
V_JÄÄDÄ	ädä
V_KAATAA	taa
V_KAIKOTA	ota
V_KAIVATA	vata
V_KALPPIA	pia
V_KAMMETA	meta
V_KANTAA	taa
V_KARHETA	ta
V_KARHUTA	ta
V_KASVAA	aa
V_KAUNISTUA	a
V_KAVETA	veta
V_KERETÄ	etä
V_KERITÄ	itä
V_KIERTYÄ	tyä
V_KIETOA	toa
V_KIHERRELLÄ	rellä
V_KIILLELLÄ	lellä
V_KIINNETÄ	netä
V_KIITÄÄ	tää
V_KIRVOTA	vota
V_KIVETTYÄ	tyä
V_KIVETÄ	vetä
V_KIVISTÄÄ	ää
V_KIVUTA	vuta
V_KOMENNELLA	nella
V_KONTIA	tia
V_KOPIOIDA	ida
V_KORVETA	veta
V_KOSIA	ia
V_KOUKUTA	uta
V_KUHERTAA	taa
V_KUKKIA	kia
V_KUMMUTA	muta
V_KUTEA	tea
V_KYNTÄÄ	tää
V_KYTKEÄ	eä
V_KÄRKKYÄ	kyä
V_KÄYDÄ	ydä
V_KÄÄNNELLÄ	nellä
V_LASSOTA	ta
V_LEIKELLÄ	ellä
V_LEPPYÄ	pyä
V_LEPÄILLÄ	illä
V_LEUDOTA	dota
V_LEVÄTÄ	vätä
V_LIIDUTA	duta
V_LOBATA	ata
V_LOITOTA	ota
V_LOPPUA	pua
V_LOTOTA	ota
V_LUNTATA	ata
V_LUUTUTA	uta
V_LÄHTEÄ	hteä
V_LÄMMETÄ	metä
V_LÄMMITÄ	mitä
V_LÄNTÄTÄ	ätä
V_MARISTA	ta
V_MAUKUA	kua
V_MELLAKOIDA	ida
V_MENNÄ	nnä
V_MERKITÄ	tä
V_MIELTYÄ	tyä
V_MIETTIÄ	tiä
V_MOITTIA	tia
V_MOJAHTAA	taa
V_MORKATA	ata
V_MULLATA	lata
V_MUODOTA	dota
V_MUTRISTAA	aa
V_MYYDÄ	ydä
V_MÄDÄTÄ	dätä
V_MÄIKYÄ	kyä
V_MÖNKIÄ	kiä
V_NAKELLA	ella
V_NAKERRELLA	rella
V_NIUKETA	eta
V_NUOKKUA	kua
V_NÄHDÄ	hdä
V_NÄPERTÄÄ	tää
V_OLLA	olla
V_OMMELLA	mella
V_ONKIA	kia
V_PALKITA	ta
V_PANNA	nna
V_PEITOTA	ota
V_PENKOA	koa
V_PIDETÄ	detä
V_PIERRÄ	rä
V_PIESTÄ	stä
V_PINGOTA	gota
V_POIKETA	eta
V_POLKEA	kea
V_PUKEA	kea
V_PULPUTA	uta
V_PUNOA	a
V_PURKAA	kaa
V_PUSERTUA	tua
V_PYYTÄÄ	tää
V_PÄTEÄ	teä
V_RAAPIA	pia
V_RAIKAA	a
V_RANGAISTA	gaista
V_RENNOTA	nota
V_REVETÄ	vetä
V_RIIPIÄ	piä
V_ROHJETA	jeta
V_ROHTUA	tua
V_RYNNÄTÄ	nätä
V_RYPEÄ	peä
V_RYSKIÄ	iä
V_RYÖPYTÄ	ytä
V_RÄPSYTTÄÄ	tää
V_SAADA	ada
V_SAARTAA	taa
V_SAMMOTA	mota
V_SATAA	taa
V_SELVITÄ	tä
V_SIEPATA	ata
V_SILIYTYÄ	tyä
V_SILPOA	poa
V_SIVALTAA	taa
V_SORTAA	taa
V_SOTKEA	ea
V_SULATELLA	ella
V_SUPETA	eta
V_SURRA	ra
V_SUUNNATA	ata
V_SYÖDÄ	yödä
V_SYÖPYÄ	pyä
V_SÄILÖÄ	ä
V_SÄPSÄHDELLÄ	dellä
V_SÄRKEÄ	keä
V_SÖRKKIÄ	kiä
V_TAITAA	taa
V_TAKOA	koa
V_TAPELLA	ella
V_TAPPAA	paa
V_TEMMATA	mata
V_TEMPOA	poa
V_TIETÄÄ	tää
V_TIPAHDELLA	della
V_TODETA	deta
V_TUIKKAA	kaa
V_TULLA	lla
V_TUNGETA	geta
V_TUNKEA	kea
V_TUNTEA	tea
V_TUODA	uoda
V_TYHJENTYÄ	tyä
V_TYLPETÄ	etä
V_TYMPIÄ	piä
V_TÄHDÄTÄ	dätä
V_TÄHYTÄ	tä
V_ULOTA	ota
V_UPOTA	ota
V_VAAHDOTA	dota
V_VAELLELLA	lella
V_VAKAANTUA	tua
V_VARTOA	toa
V_VAVISTA	vista
V_VERRATA	rata
V_VIEDÄ	iedä
V_VIEROITTAA	taa
V_VIHELTÄÄ	tää
V_VIITTOA	toa
V_VINKUA	kua
V_VIPAJAA	aa
V_VIRKKAA	kaa
V_VONGATA	gata
V_VYYHDETÄ	detä
V_VÄHETÄ	tä
V_VÄLPÄTÄ	ätä
V_VÄNGÄTÄ	gätä
V_YLTÄÄ	tää
V_YNNÄTÄ	tä
V_YSKÄHTÄÄ	tää
V_YÖKÄTÄ	ätä
V_ÄHKÄÄ	ä
V_ÄKSYILLÄ	lä
V_ÄLLISTYÄ	ä
V_ÄNGETÄ	getä
V_ÄRISTÄ	tä
V_ÖYKKÄRÖIDÄ	idä
SYMBOL_PISTE	
SYMBOL_PILKKU	
PUNCT_NONSTD_EXCL_LOOP	
ACRO_AA	
ACRO_CELSIUS	
ACRO_DOLLARI	
ACRO_EE	
ACRO_EURO	
ACRO_GRAMMA	
ACRO_GRAY	
ACRO_II	
ACRO_JOULE	
ACRO_JÄRJESTÖ	
ACRO_KAHDEKSAN	
ACRO_KAKSI	
ACRO_KANDELA	
ACRO_KOLMAS	
ACRO_KOLME	
ACRO_KUUSI	
ACRO_LEHTI	
ACRO_LUSIKKA	
ACRO_METRI	
ACRO_NELJÄ	
#ACRO_NELJÄS	
ACRO_NOLLA	
ACRO_OHMI	
ACRO_OIKEUS	
ACRO_OK	
ACRO_OO	
ACRO_OPISTO	
ACRO_OPPILAS	
ACRO_PUNTA	
ACRO_PYKÄLÄ	
ACRO_SAIRAALA	
ACRO_SEITSEMÄN	
ACRO_SENTTI	
ACRO_TALO	
ACRO_TUOTE	
ACRO_UU	
ACRO_VIISI	
ACRO_VUOSI	
ACRO_WEBER	
ACRO_YHDEKSÄN	
ACRO_YHDISTYS	
ACRO_YKSI	
ACRO_YY	
ACRO_ZET	
ACRO_ÄKS	
ACRO_ÄÄ	
ACRO_ÖÖ	
PCLE_AIKANSA	
PCLE_ALLE	
PCLE_HAH	
PCLE_HYVILLÄÄN	än
PCLE_IKINÄ	
PCLE_ILKOSILLAAN	an
PCLE_ISTUALLEEN	en
PCLE_KOTONA	
PCLE_JO	
PCLE_JONNE	
PCLE_KUHUN	
PCLE_LEVÄLLEEN	
PCLE_VAAN	
PCLE_LISÄKSI	
PCLE_MITEN	
PCLE_NOPEASTI	
PCLE_NÄHDEN	
PCLE_NÄKYVIIN	n
PCLE_TYHMÄSTI	
PCLE_TYKÖ	
PCLE_VALTAAN	n
PCLE_VUOKSI	
PCLE_YLIPÄÄNSÄ	
PCLE_YLLE	
N_51Iso-Britannia	-Britannia
N_51Mustameri	ameri
N_51Punainenmeri	nenmeri
N_51Uusikaupunki	sikaupunki
N_51Uusimaa	simaa
N_51Uusi-Seelanti	si-Seelanti
N_51aavameri	ameri
N_51hienosokeri	sokeri
N_51isojako	jako
N_51isokoskelo	koskelo
N_51isokuovi	kuovi
N_51isokäpylintu	käpylintu
N_51isolepinkäinen	lepinkäinen
N_51isolokki	lokki
N_51isomaksaruoho	maksaruoho
N_51isomasto	masto
N_51isopanda	panda
N_51isopistooli	pistooli
N_51isopurje	purje
N_51isorokko	rokko
N_51isorumpu	rumpu
N_51isosisar	sisar
N_51isosisko	sisko
N_51isotaivot	taivot
N_51isovarvas	varvas
N_51isoveli	veli
N_51isoviha	viha
N_51karkearehu	arehu
N_51kevytsarja	tsarja
N_51kirjavapillike	apillike
N_51kuivakakku	akakku
N_51kuivakukka	akukka
N_51kuivamuona	amuona
N_51kuivapaino	apaino
N_51kuivapari	apari
N_51kuivarehu	arehu
N_51kultainennoutaja	nennoutaja
N_51laiskakoira	akoira
N_51lämminruoka	minruoka
N_51lämminvarasto	minvarasto
N_51lämminvaunu	minvaunu
N_51matalameri	ameri
N_51mustaherukka	aherukka
N_51mustaleipä	aleipä
N_51mustaleski	aleski
N_51mustalintu	alintu
N_51mustamaija	amaija
N_51mustamakkara	amakkara
N_51mustamies	amies
N_51mustamulta	amulta
N_51mustapekka	apekka
N_51mustapippuri	apippuri
N_51mustaraamattu	araamattu
N_51mustatorvisieni	atorvisieni
N_51mustaviinimarja	aviinimarja
N_51nuoriemäntä	iemäntä
N_51nuoriherra	iherra
N_51nuori-isäntä	i-isäntä
N_51nuorikarja	ikarja
N_51nuorimies	imies
N_51nuoripari	ipari
N_51omakuva	akuva
N_51omatunto	atunto
N_51pahahenki	ahenki
N_51pahaputki	aputki
N_51palavakivi	akivi
N_51palavapensas	apensas
N_51palavarakkaus	arakkaus
N_51pitkähousu	ähousu
N_51pitkäkirkko	äkirkko
N_51pitkäperjantai	äperjantai
N_51pitkäpiimä	äpiimä
N_51pitkäsiima	äsiima
N_51pitkätakki	ätakki
N_51pitkäthousut	äthousut
N_51puolikuu	ikuu
N_51puolimatka	imatka
N_51puolipäivä	ipäivä
N_51puoliväli	iväli
N_51puoliyö	iyö
N_51raitisilma	isilma
N_51raskassarja	ssarja
N_51raskasvesi	svesi
N_51raskasvety	svety
N_51sepiväpeippi	äpeippi
N_51suorakulma	akulma
N_51suoraommel	aommel
N_51syvämeri	ämeri
N_51särkynytsydän	ytsydän
N_51tyhjäpaino	äpaino
N_51täysikuu	sikuu
N_51uusikuu	sikuu
N_51uusivuosi	sivuosi
N_51vanhaemäntä	aemäntä
N_51vanhaisäntä	aisäntä
N_51vanhakaupunki	akaupunki
N_51vanhapiika	apiika
N_51vanhapoika	apoika
N_51vierasmies	vierasmies
X_51eikä	ikä
X_51ehkei	i
X_51ettei	i
X_51jollei	i
X_51jottei	i
X_51miksei	i
X_51muttei	i
X_51vaikkei	i
NUM_51kahdeksanbiljardia	anbiljardia
NUM_51kahdeksanbiljoonaa	anbiljoonaa
NUM_51kahdeksandekiljardia	andekiljardia
NUM_51kahdeksandekiljoonaa	andekiljoonaa
NUM_51kahdeksanduodekiljardia	anduodekiljardia
NUM_51kahdeksanduodekiljoonaa	anduodekiljoonaa
NUM_51kahdeksankahdeksatta	ankahdeksatta
NUM_51kahdeksankiljardia	ankiljardia
NUM_51kahdeksankiljoonaa	ankiljoonaa
NUM_51kahdeksankolmatta	ankolmatta
NUM_51kahdeksankuudetta	ankuudetta
NUM_51kahdeksankvadriljardia	ankvadriljardia
NUM_51kahdeksankvadriljoonaa	ankvadriljoonaa
NUM_51kahdeksankvintiljardia	ankvintiljardia
NUM_51kahdeksankvintiljoonaa	ankvintiljoonaa
NUM_51kahdeksankymmentä	ankymmentä
NUM_51kahdeksanmiljardia	anmiljardia
NUM_51kahdeksanmiljoonaa	anmiljoonaa
NUM_51kahdeksanneljättä	anneljättä
NUM_51kahdeksannoniljardia	annoniljardia
NUM_51kahdeksannoniljoonaa	annoniljoonaa
NUM_51kahdeksanoktiljardia	anoktiljardia
NUM_51kahdeksanoktiljoonaa	anoktiljoonaa
NUM_51kahdeksanpiljardia	anpiljardia
NUM_51kahdeksanpiljoonaa	anpiljoonaa
NUM_51kahdeksansataa	ansataa
NUM_51kahdeksanseitsemättä	anseitsemättä
NUM_51kahdeksansentiljardia	ansentiljardia
NUM_51kahdeksansentiljoonaa	ansentiljoonaa
NUM_51kahdeksanseptiljardia	anseptiljardia
NUM_51kahdeksanseptiljoonaa	anseptiljoonaa
NUM_51kahdeksantoista	antoista
NUM_51kahdeksantredekiljardia	antredekiljardia
NUM_51kahdeksantredekiljoonaa	antredekiljoonaa
NUM_51kahdeksantriljardia	antriljardia
NUM_51kahdeksantriljoonaa	antriljoonaa
NUM_51kahdeksantsiljardia	antsiljardia
NUM_51kahdeksantsiljoonaa	antsiljoonaa
NUM_51kahdeksantuhatta	antuhatta
NUM_51kahdeksanundekiljardia	anundekiljardia
NUM_51kahdeksanundekiljoonaa	anundekiljoonaa
NUM_51kahdeksanviidettä	anviidettä
NUM_51kahdeksanyhdeksättä	anyhdeksättä
NUM_51kahdeksasbiljardis	asbiljardis
NUM_51kahdeksasbiljoonas	asbiljoonas
NUM_51kahdeksasdekiljardis	asdekiljardis
NUM_51kahdeksasdekiljoonas	asdekiljoonas
NUM_51kahdeksasduodekiljardis	asduodekiljardis
NUM_51kahdeksasduodekiljoonas	asduodekiljoonas
NUM_51kahdeksaskahdeksatta	askahdeksatta
NUM_51kahdeksaskiljardis	askiljardis
NUM_51kahdeksaskiljoonas	askiljoonas
NUM_51kahdeksaskolmatta	askolmatta
NUM_51kahdeksaskuudetta	askuudetta
NUM_51kahdeksaskvadriljardis	askvadriljardis
NUM_51kahdeksaskvadriljoonas	askvadriljoonas
NUM_51kahdeksaskvintiljardis	askvintiljardis
NUM_51kahdeksaskvintiljoonas	askvintiljoonas
NUM_51kahdeksaskymmenes	askymmenes
NUM_51kahdeksasmiljardis	asmiljardis
NUM_51kahdeksasmiljoonas	asmiljoonas
NUM_51kahdeksasneljästtä	asneljästtä
NUM_51kahdeksasnoniljardis	asnoniljardis
NUM_51kahdeksasnoniljoonas	asnoniljoonas
NUM_51kahdeksasoktiljardis	asoktiljardis
NUM_51kahdeksasoktiljoonas	asoktiljoonas
NUM_51kahdeksaspiljardis	aspiljardis
NUM_51kahdeksaspiljoonas	aspiljoonas
NUM_51kahdeksassadas	assadas
NUM_51kahdeksasseitsemättä	asseitsemättä
NUM_51kahdeksassentiljardis	assentiljardis
NUM_51kahdeksassentiljoonas	assentiljoonas
NUM_51kahdeksasseptiljardis	asseptiljardis
NUM_51kahdeksasseptiljoonas	asseptiljoonas
NUM_51kahdeksastoista	astoista
NUM_51kahdeksastredekiljardis	astredekiljardis
NUM_51kahdeksastredekiljoonas	astredekiljoonas
NUM_51kahdeksastriljardis	astriljardis
NUM_51kahdeksastriljoonas	astriljoonas
NUM_51kahdeksastsiljardis	astsiljardis
NUM_51kahdeksastsiljoonas	astsiljoonas
NUM_51kahdeksastuhannes	astuhannes
NUM_51kahdeksasundekiljardis	asundekiljardis
NUM_51kahdeksasundekiljoonas	asundekiljoonas
NUM_51kahdeksasviidettä	asviidettä
NUM_51kahdeksasyhdeksättä	asyhdeksättä
NUM_51kahdesbiljardis	sbiljardis
NUM_51kahdesbiljoonas	sbiljoonas
NUM_51kahdesdekiljardis	sdekiljardis
NUM_51kahdesdekiljoonas	sdekiljoonas
NUM_51kahdesduodekiljardis	sduodekiljardis
NUM_51kahdesduodekiljoonas	sduodekiljoonas
NUM_51kahdeskahdeksatta	skahdeksatta
NUM_51kahdeskiljardis	skiljardis
NUM_51kahdeskiljoonas	skiljoonas
NUM_51kahdeskolmatta	skolmatta
NUM_51kahdeskuudetta	skuudetta
NUM_51kahdeskvadriljardis	skvadriljardis
NUM_51kahdeskvadriljoonas	skvadriljoonas
NUM_51kahdeskvintiljardis	skvintiljardis
NUM_51kahdeskvintiljoonas	skvintiljoonas
NUM_51kahdeskymmenes	skymmenes
NUM_51kahdesmiljardis	smiljardis
NUM_51kahdesmiljoonas	smiljoonas
NUM_51kahdesneljästtä	sneljästtä
NUM_51kahdesnoniljardis	snoniljardis
NUM_51kahdesnoniljoonas	snoniljoonas
NUM_51kahdesoktiljardis	soktiljardis
NUM_51kahdesoktiljoonas	soktiljoonas
NUM_51kahdespiljardis	spiljardis
NUM_51kahdespiljoonas	spiljoonas
NUM_51kahdessadas	ssadas
NUM_51kahdesseitsemättä	sseitsemättä
NUM_51kahdessentiljardis	ssentiljardis
NUM_51kahdessentiljoonas	ssentiljoonas
NUM_51kahdesseptiljardis	sseptiljardis
NUM_51kahdesseptiljoonas	sseptiljoonas
NUM_51kahdestoista	stoista
NUM_51kahdestredekiljardis	stredekiljardis
NUM_51kahdestredekiljoonas	stredekiljoonas
NUM_51kahdestriljardis	striljardis
NUM_51kahdestriljoonas	striljoonas
NUM_51kahdestsiljardis	stsiljardis
NUM_51kahdestsiljoonas	stsiljoonas
NUM_51kahdestuhannes	stuhannes
NUM_51kahdesundekiljardis	sundekiljardis
NUM_51kahdesundekiljoonas	sundekiljoonas
NUM_51kahdesviidettä	sviidettä
NUM_51kahdesyhdeksättä	syhdeksättä
NUM_51kaksibiljardia	ksibiljardia
NUM_51kaksibiljoonaa	ksibiljoonaa
NUM_51kaksidekiljardia	ksidekiljardia
NUM_51kaksidekiljoonaa	ksidekiljoonaa
NUM_51kaksiduodekiljardia	ksiduodekiljardia
NUM_51kaksiduodekiljoonaa	ksiduodekiljoonaa
NUM_51kaksikahdeksatta	ksikahdeksatta
NUM_51kaksikiljardia	ksikiljardia
NUM_51kaksikiljoonaa	ksikiljoonaa
NUM_51kaksikolmatta	ksikolmatta
NUM_51kaksikuudetta	ksikuudetta
NUM_51kaksikvadriljardia	ksikvadriljardia
NUM_51kaksikvadriljoonaa	ksikvadriljoonaa
NUM_51kaksikvintiljardia	ksikvintiljardia
NUM_51kaksikvintiljoonaa	ksikvintiljoonaa
NUM_51kaksikymmentä	ksikymmentä
NUM_51kaksimiljardia	ksimiljardia
NUM_51kaksimiljoonaa	ksimiljoonaa
NUM_51kaksineljättä	ksineljättä
NUM_51kaksinoniljardia	ksinoniljardia
NUM_51kaksinoniljoonaa	ksinoniljoonaa
NUM_51kaksioktiljardia	ksioktiljardia
NUM_51kaksioktiljoonaa	ksioktiljoonaa
NUM_51kaksipiljardia	ksipiljardia
NUM_51kaksipiljoonaa	ksipiljoonaa
NUM_51kaksisataa	ksisataa
NUM_51kaksiseitsemättä	ksiseitsemättä
NUM_51kaksisentiljardia	ksisentiljardia
NUM_51kaksisentiljoonaa	ksisentiljoonaa
NUM_51kaksiseptiljardia	ksiseptiljardia
NUM_51kaksiseptiljoonaa	ksiseptiljoonaa
NUM_51kaksitoista	ksitoista
NUM_51kaksitredekiljardia	ksitredekiljardia
NUM_51kaksitredekiljoonaa	ksitredekiljoonaa
NUM_51kaksitriljardia	ksitriljardia
NUM_51kaksitriljoonaa	ksitriljoonaa
NUM_51kaksitsiljardia	ksitsiljardia
NUM_51kaksitsiljoonaa	ksitsiljoonaa
NUM_51kaksituhatta	ksituhatta
NUM_51kaksiundekiljardia	ksiundekiljardia
NUM_51kaksiundekiljoonaa	ksiundekiljoonaa
NUM_51kaksiviidettä	ksiviidettä
NUM_51kaksiyhdeksättä	ksiyhdeksättä
NUM_51kolmasbiljardis	sbiljardis
NUM_51kolmasbiljoonas	sbiljoonas
NUM_51kolmasdekiljardis	sdekiljardis
NUM_51kolmasdekiljoonas	sdekiljoonas
NUM_51kolmasduodekiljardis	sduodekiljardis
NUM_51kolmasduodekiljoonas	sduodekiljoonas
NUM_51kolmaskahdeksatta	skahdeksatta
NUM_51kolmaskiljardis	skiljardis
NUM_51kolmaskiljoonas	skiljoonas
NUM_51kolmaskolmatta	skolmatta
NUM_51kolmaskuudetta	skuudetta
NUM_51kolmaskvadriljardis	skvadriljardis
NUM_51kolmaskvadriljoonas	skvadriljoonas
NUM_51kolmaskvintiljardis	skvintiljardis
NUM_51kolmaskvintiljoonas	skvintiljoonas
NUM_51kolmaskymmenes	skymmenes
NUM_51kolmasmiljardis	smiljardis
NUM_51kolmasmiljoonas	smiljoonas
NUM_51kolmasneljättä	sneljättä
NUM_51kolmasnoniljardis	snoniljardis
NUM_51kolmasnoniljoonas	snoniljoonas
NUM_51kolmasoktiljardis	soktiljardis
NUM_51kolmasoktiljoonas	soktiljoonas
NUM_51kolmaspiljardis	spiljardis
NUM_51kolmaspiljoonas	spiljoonas
NUM_51kolmassadas	ssadas
NUM_51kolmasseitsemättä	sseitsemättä
NUM_51kolmassentiljardis	ssentiljardis
NUM_51kolmassentiljoonas	ssentiljoonas
NUM_51kolmasseptiljardis	sseptiljardis
NUM_51kolmasseptiljoonas	sseptiljoonas
NUM_51kolmastoista	stoista
NUM_51kolmastredekiljardis	stredekiljardis
NUM_51kolmastredekiljoonas	stredekiljoonas
NUM_51kolmastriljardis	striljardis
NUM_51kolmastriljoonas	striljoonas
NUM_51kolmastsiljardis	stsiljardis
NUM_51kolmastsiljoonas	stsiljoonas
NUM_51kolmastuhannes	stuhannes
NUM_51kolmasundekiljardis	sundekiljardis
NUM_51kolmasundekiljoonas	sundekiljoonas
NUM_51kolmasviidettä	sviidettä
NUM_51kolmasyhdeksättä	syhdeksättä
NUM_51kolmebiljardia	ebiljardia
NUM_51kolmebiljoonaa	ebiljoonaa
NUM_51kolmedekiljardia	edekiljardia
NUM_51kolmedekiljoonaa	edekiljoonaa
NUM_51kolmeduodekiljardia	eduodekiljardia
NUM_51kolmeduodekiljoonaa	eduodekiljoonaa
NUM_51kolmekahdeksatta	ekahdeksatta
NUM_51kolmekiljardia	ekiljardia
NUM_51kolmekiljoonaa	ekiljoonaa
NUM_51kolmekolmatta	ekolmatta
NUM_51kolmekuudetta	ekuudetta
NUM_51kolmekvadriljardia	ekvadriljardia
NUM_51kolmekvadriljoonaa	ekvadriljoonaa
NUM_51kolmekvintiljardia	ekvintiljardia
NUM_51kolmekvintiljoonaa	ekvintiljoonaa
NUM_51kolmekymmentä	ekymmentä
NUM_51kolmemiljardia	emiljardia
NUM_51kolmemiljoonaa	emiljoonaa
NUM_51kolmeneljättä	eneljättä
NUM_51kolmenoniljardia	enoniljardia
NUM_51kolmenoniljoonaa	enoniljoonaa
NUM_51kolmeoktiljardia	eoktiljardia
NUM_51kolmeoktiljoonaa	eoktiljoonaa
NUM_51kolmepiljardia	epiljardia
NUM_51kolmepiljoonaa	epiljoonaa
NUM_51kolmesataa	esataa
NUM_51kolmeseitsemättä	eseitsemättä
NUM_51kolmesentiljardia	esentiljardia
NUM_51kolmesentiljoonaa	esentiljoonaa
NUM_51kolmeseptiljardia	eseptiljardia
NUM_51kolmeseptiljoonaa	eseptiljoonaa
NUM_51kolmetoista	etoista
NUM_51kolmetredekiljardia	etredekiljardia
NUM_51kolmetredekiljoonaa	etredekiljoonaa
NUM_51kolmetriljardia	etriljardia
NUM_51kolmetriljoonaa	etriljoonaa
NUM_51kolmetsiljardia	etsiljardia
NUM_51kolmetsiljoonaa	etsiljoonaa
NUM_51kolmetuhatta	etuhatta
NUM_51kolmeundekiljardia	eundekiljardia
NUM_51kolmeundekiljoonaa	eundekiljoonaa
NUM_51kolmeviidettä	eviidettä
NUM_51kolmeyhdeksättä	eyhdeksättä
NUM_51kuudesbiljardis	sbiljardis
NUM_51kuudesbiljoonas	sbiljoonas
NUM_51kuudesdekiljardis	sdekiljardis
NUM_51kuudesdekiljoonas	sdekiljoonas
NUM_51kuudesduodekiljardis	sduodekiljardis
NUM_51kuudesduodekiljoonas	sduodekiljoonas
NUM_51kuudeskahdeksatta	skahdeksatta
NUM_51kuudeskiljardis	skiljardis
NUM_51kuudeskiljoonas	skiljoonas
NUM_51kuudeskolmatta	skolmatta
NUM_51kuudeskuudetta	skuudetta
NUM_51kuudeskvadriljardis	skvadriljardis
NUM_51kuudeskvadriljoonas	skvadriljoonas
NUM_51kuudeskvintiljardis	skvintiljardis
NUM_51kuudeskvintiljoonas	skvintiljoonas
NUM_51kuudeskymmenes	skymmenes
NUM_51kuudesmiljardis	smiljardis
NUM_51kuudesmiljoonas	smiljoonas
NUM_51kuudesneljästtä	sneljästtä
NUM_51kuudesnoniljardis	snoniljardis
NUM_51kuudesnoniljoonas	snoniljoonas
NUM_51kuudesoktiljardis	soktiljardis
NUM_51kuudesoktiljoonas	soktiljoonas
NUM_51kuudespiljardis	spiljardis
NUM_51kuudespiljoonas	spiljoonas
NUM_51kuudessadas	ssadas
NUM_51kuudesseitsemättä	sseitsemättä
NUM_51kuudessentiljardis	ssentiljardis
NUM_51kuudessentiljoonas	ssentiljoonas
NUM_51kuudesseptiljardis	sseptiljardis
NUM_51kuudesseptiljoonas	sseptiljoonas
NUM_51kuudestoista	stoista
NUM_51kuudestredekiljardis	stredekiljardis
NUM_51kuudestredekiljoonas	stredekiljoonas
NUM_51kuudestriljardis	striljardis
NUM_51kuudestriljoonas	striljoonas
NUM_51kuudestsiljardis	stsiljardis
NUM_51kuudestsiljoonas	stsiljoonas
NUM_51kuudestuhannes	stuhannes
NUM_51kuudesundekiljardis	sundekiljardis
NUM_51kuudesundekiljoonas	sundekiljoonas
NUM_51kuudesviidettä	sviidettä
NUM_51kuudesyhdeksättä	syhdeksättä
NUM_51kuusibiljardia	sibiljardia
NUM_51kuusibiljoonaa	sibiljoonaa
NUM_51kuusidekiljardia	sidekiljardia
NUM_51kuusidekiljoonaa	sidekiljoonaa
NUM_51kuusiduodekiljardia	siduodekiljardia
NUM_51kuusiduodekiljoonaa	siduodekiljoonaa
NUM_51kuusikahdeksatta	sikahdeksatta
NUM_51kuusikiljardia	sikiljardia
NUM_51kuusikiljoonaa	sikiljoonaa
NUM_51kuusikolmatta	sikolmatta
NUM_51kuusikuudetta	sikuudetta
NUM_51kuusikvadriljardia	sikvadriljardia
NUM_51kuusikvadriljoonaa	sikvadriljoonaa
NUM_51kuusikvintiljardia	sikvintiljardia
NUM_51kuusikvintiljoonaa	sikvintiljoonaa
NUM_51kuusikymmentä	sikymmentä
NUM_51kuusimiljardia	similjardia
NUM_51kuusimiljoonaa	similjoonaa
NUM_51kuusineljättä	sineljättä
NUM_51kuusinoniljardia	sinoniljardia
NUM_51kuusinoniljoonaa	sinoniljoonaa
NUM_51kuusioktiljardia	sioktiljardia
NUM_51kuusioktiljoonaa	sioktiljoonaa
NUM_51kuusipiljardia	sipiljardia
NUM_51kuusipiljoonaa	sipiljoonaa
NUM_51kuusisataa	sisataa
NUM_51kuusiseitsemättä	siseitsemättä
NUM_51kuusisentiljardia	sisentiljardia
NUM_51kuusisentiljoonaa	sisentiljoonaa
NUM_51kuusiseptiljardia	siseptiljardia
NUM_51kuusiseptiljoonaa	siseptiljoonaa
NUM_51kuusitoista	sitoista
NUM_51kuusitredekiljardia	sitredekiljardia
NUM_51kuusitredekiljoonaa	sitredekiljoonaa
NUM_51kuusitriljardia	sitriljardia
NUM_51kuusitriljoonaa	sitriljoonaa
NUM_51kuusitsiljardia	sitsiljardia
NUM_51kuusitsiljoonaa	sitsiljoonaa
NUM_51kuusituhatta	situhatta
NUM_51kuusiundekiljardia	siundekiljardia
NUM_51kuusiundekiljoonaa	siundekiljoonaa
NUM_51kuusiviidettä	siviidettä
NUM_51kuusiyhdeksättä	siyhdeksättä
NUM_51neljäbiljardia	äbiljardia
NUM_51neljäbiljoonaa	äbiljoonaa
NUM_51neljädekiljardia	ädekiljardia
NUM_51neljädekiljoonaa	ädekiljoonaa
NUM_51neljäduodekiljardia	äduodekiljardia
NUM_51neljäduodekiljoonaa	äduodekiljoonaa
NUM_51neljäkahdeksatta	äkahdeksatta
NUM_51neljäkiljardia	äkiljardia
NUM_51neljäkiljoonaa	äkiljoonaa
NUM_51neljäkolmatta	äkolmatta
NUM_51neljäkuudetta	äkuudetta
NUM_51neljäkvadriljardia	äkvadriljardia
NUM_51neljäkvadriljoonaa	äkvadriljoonaa
NUM_51neljäkvintiljardia	äkvintiljardia
NUM_51neljäkvintiljoonaa	äkvintiljoonaa
NUM_51neljäkymmentä	äkymmentä
NUM_51neljämiljardia	ämiljardia
NUM_51neljämiljoonaa	ämiljoonaa
NUM_51neljäneljättä	äneljättä
NUM_51neljänoniljardia	änoniljardia
NUM_51neljänoniljoonaa	änoniljoonaa
NUM_51neljäoktiljardia	äoktiljardia
NUM_51neljäoktiljoonaa	äoktiljoonaa
NUM_51neljäpiljardia	äpiljardia
NUM_51neljäpiljoonaa	äpiljoonaa
NUM_51neljäsataa	äsataa
NUM_51neljäsbiljardis	sbiljardis
NUM_51neljäsbiljoonas	sbiljoonas
NUM_51neljäsdekiljardis	sdekiljardis
NUM_51neljäsdekiljoonas	sdekiljoonas
NUM_51neljäsduodekiljardis	sduodekiljardis
NUM_51neljäsduodekiljoonas	sduodekiljoonas
NUM_51neljäseitsemättä	seitsemättä
NUM_51neljäsentiljardia	sentiljardia
NUM_51neljäsentiljoonaa	sentiljoonaa
NUM_51neljäseptiljardia	septiljardia
NUM_51neljäseptiljoonaa	septiljoonaa
NUM_51neljäskahdeksatta	skahdeksatta
NUM_51neljäskiljardis	skiljardis
NUM_51neljäskiljoonas	skiljoonas
NUM_51neljäskolmatta	skolmatta
NUM_51neljäskuudetta	skuudetta
NUM_51neljäskvadriljardis	skvadriljardis
NUM_51neljäskvadriljoonas	skvadriljoonas
NUM_51neljäskvintiljardis	skvintiljardis
NUM_51neljäskvintiljoonas	skvintiljoonas
NUM_51neljäskymmenes	skymmenes
NUM_51neljäsmiljardis	smiljardis
NUM_51neljäsmiljoonas	smiljoonas
NUM_51neljäsneljättä	sneljättä
NUM_51neljäsnoniljardis	snoniljardis
NUM_51neljäsnoniljoonas	snoniljoonas
NUM_51neljäsoktiljardis	soktiljardis
NUM_51neljäsoktiljoonas	soktiljoonas
NUM_51neljäspiljardis	spiljardis
NUM_51neljäspiljoonas	spiljoonas
NUM_51neljässadas	ssadas
NUM_51neljässeitsemättä	sseitsemättä
NUM_51neljässentiljardis	ssentiljardis
NUM_51neljässentiljoonas	ssentiljoonas
NUM_51neljässeptiljardis	sseptiljardis
NUM_51neljässeptiljoonas	sseptiljoonas
NUM_51neljästoista	stoista
NUM_51neljästredekiljardis	stredekiljardis
NUM_51neljästredekiljoonas	stredekiljoonas
NUM_51neljästriljardis	striljardis
NUM_51neljästriljoonas	striljoonas
NUM_51neljästsiljardis	stsiljardis
NUM_51neljästsiljoonas	stsiljoonas
NUM_51neljästuhannes	stuhannes
NUM_51neljäsundekiljardis	sundekiljardis
NUM_51neljäsundekiljoonas	sundekiljoonas
NUM_51neljäsviidettä	sviidettä
NUM_51neljäsyhdeksättä	syhdeksättä
NUM_51neljätoista	ätoista
NUM_51neljätredekiljardia	ätredekiljardia
NUM_51neljätredekiljoonaa	ätredekiljoonaa
NUM_51neljätriljardia	ätriljardia
NUM_51neljätriljoonaa	ätriljoonaa
NUM_51neljätsiljardia	ätsiljardia
NUM_51neljätsiljoonaa	ätsiljoonaa
NUM_51neljätuhatta	ätuhatta
NUM_51neljäundekiljardia	äundekiljardia
NUM_51neljäundekiljoonaa	äundekiljoonaa
NUM_51neljäviidettä	äviidettä
NUM_51neljäyhdeksättä	äyhdeksättä
NUM_51puolitoista	puolitoista
NUM_51seitsemänbiljardia	änbiljardia
NUM_51seitsemänbiljoonaa	änbiljoonaa
NUM_51seitsemändekiljardia	ändekiljardia
NUM_51seitsemändekiljoonaa	ändekiljoonaa
NUM_51seitsemänduodekiljardia	änduodekiljardia
NUM_51seitsemänduodekiljoonaa	änduodekiljoonaa
NUM_51seitsemänkahdeksatta	änkahdeksatta
NUM_51seitsemänkiljardia	änkiljardia
NUM_51seitsemänkiljoonaa	änkiljoonaa
NUM_51seitsemänkolmatta	änkolmatta
NUM_51seitsemänkuudetta	änkuudetta
NUM_51seitsemänkvadriljardia	änkvadriljardia
NUM_51seitsemänkvadriljoonaa	änkvadriljoonaa
NUM_51seitsemänkvintiljardia	änkvintiljardia
NUM_51seitsemänkvintiljoonaa	änkvintiljoonaa
NUM_51seitsemänkymmentä	änkymmentä
NUM_51seitsemänmiljardia	änmiljardia
NUM_51seitsemänmiljoonaa	änmiljoonaa
NUM_51seitsemänneljättä	änneljättä
NUM_51seitsemännoniljardia	ännoniljardia
NUM_51seitsemännoniljoonaa	ännoniljoonaa
NUM_51seitsemänoktiljardia	änoktiljardia
NUM_51seitsemänoktiljoonaa	änoktiljoonaa
NUM_51seitsemänpiljardia	änpiljardia
NUM_51seitsemänpiljoonaa	änpiljoonaa
NUM_51seitsemänsataa	änsataa
NUM_51seitsemänseitsemättä	änseitsemättä
NUM_51seitsemänsentiljardia	änsentiljardia
NUM_51seitsemänsentiljoonaa	änsentiljoonaa
NUM_51seitsemänseptiljardia	änseptiljardia
NUM_51seitsemänseptiljoonaa	änseptiljoonaa
NUM_51seitsemäntoista	äntoista
NUM_51seitsemäntredekiljardia	äntredekiljardia
NUM_51seitsemäntredekiljoonaa	äntredekiljoonaa
NUM_51seitsemäntriljardia	äntriljardia
NUM_51seitsemäntriljoonaa	äntriljoonaa
NUM_51seitsemäntsiljardia	äntsiljardia
NUM_51seitsemäntsiljoonaa	äntsiljoonaa
NUM_51seitsemäntuhatta	äntuhatta
NUM_51seitsemänundekiljardia	änundekiljardia
NUM_51seitsemänundekiljoonaa	änundekiljoonaa
NUM_51seitsemänviidettä	änviidettä
NUM_51seitsemänyhdeksättä	änyhdeksättä
NUM_51seitsemäsbiljardis	sbiljardis
NUM_51seitsemäsbiljoonas	sbiljoonas
NUM_51seitsemäsdekiljardis	sdekiljardis
NUM_51seitsemäsdekiljoonas	sdekiljoonas
NUM_51seitsemäsduodekiljardis	sduodekiljardis
NUM_51seitsemäsduodekiljoonas	sduodekiljoonas
NUM_51seitsemäskahdeksatta	skahdeksatta
NUM_51seitsemäskiljardis	skiljardis
NUM_51seitsemäskiljoonas	skiljoonas
NUM_51seitsemäskolmatta	skolmatta
NUM_51seitsemäskuudetta	skuudetta
NUM_51seitsemäskvadriljardis	skvadriljardis
NUM_51seitsemäskvadriljoonas	skvadriljoonas
NUM_51seitsemäskvintiljardis	skvintiljardis
NUM_51seitsemäskvintiljoonas	skvintiljoonas
NUM_51seitsemäskymmenes	skymmenes
NUM_51seitsemäsmiljardis	smiljardis
NUM_51seitsemäsmiljoonas	smiljoonas
NUM_51seitsemäsneljästtä	sneljästtä
NUM_51seitsemäsnoniljardis	snoniljardis
NUM_51seitsemäsnoniljoonas	snoniljoonas
NUM_51seitsemäsoktiljardis	soktiljardis
NUM_51seitsemäsoktiljoonas	soktiljoonas
NUM_51seitsemäspiljardis	spiljardis
NUM_51seitsemäspiljoonas	spiljoonas
NUM_51seitsemässadas	ssadas
NUM_51seitsemässeitsemättä	sseitsemättä
NUM_51seitsemässentiljardis	ssentiljardis
NUM_51seitsemässentiljoonas	ssentiljoonas
NUM_51seitsemässeptiljardis	sseptiljardis
NUM_51seitsemässeptiljoonas	sseptiljoonas
NUM_51seitsemästoista	stoista
NUM_51seitsemästredekiljardis	stredekiljardis
NUM_51seitsemästredekiljoonas	stredekiljoonas
NUM_51seitsemästriljardis	striljardis
NUM_51seitsemästriljoonas	striljoonas
NUM_51seitsemästsiljardis	stsiljardis
NUM_51seitsemästsiljoonas	stsiljoonas
NUM_51seitsemästuhannes	stuhannes
NUM_51seitsemäsundekiljardis	sundekiljardis
NUM_51seitsemäsundekiljoonas	sundekiljoonas
NUM_51seitsemäsviidettä	sviidettä
NUM_51seitsemäsyhdeksättä	syhdeksättä
NUM_51viidesbiljardis	sbiljardis
NUM_51viidesbiljoonas	sbiljoonas
NUM_51viidesdekiljardis	sdekiljardis
NUM_51viidesdekiljoonas	sdekiljoonas
NUM_51viidesduodekiljardis	sduodekiljardis
NUM_51viidesduodekiljoonas	sduodekiljoonas
NUM_51viideskahdeksatta	skahdeksatta
NUM_51viideskiljardis	skiljardis
NUM_51viideskiljoonas	skiljoonas
NUM_51viideskolmatta	skolmatta
NUM_51viideskuudetta	skuudetta
NUM_51viideskvadriljardis	skvadriljardis
NUM_51viideskvadriljoonas	skvadriljoonas
NUM_51viideskvintiljardis	skvintiljardis
NUM_51viideskvintiljoonas	skvintiljoonas
NUM_51viideskymmenes	skymmenes
NUM_51viidesmiljardis	smiljardis
NUM_51viidesmiljoonas	smiljoonas
NUM_51viidesneljästtä	sneljästtä
NUM_51viidesnoniljardis	snoniljardis
NUM_51viidesnoniljoonas	snoniljoonas
NUM_51viidesoktiljardis	soktiljardis
NUM_51viidesoktiljoonas	soktiljoonas
NUM_51viidespiljardis	spiljardis
NUM_51viidespiljoonas	spiljoonas
NUM_51viidessadas	ssadas
NUM_51viidesseitsemättä	sseitsemättä
NUM_51viidessentiljardis	ssentiljardis
NUM_51viidessentiljoonas	ssentiljoonas
NUM_51viidesseptiljardis	sseptiljardis
NUM_51viidesseptiljoonas	sseptiljoonas
NUM_51viidestoista	stoista
NUM_51viidestredekiljardis	stredekiljardis
NUM_51viidestredekiljoonas	stredekiljoonas
NUM_51viidestriljardis	striljardis
NUM_51viidestriljoonas	striljoonas
NUM_51viidestsiljardis	stsiljardis
NUM_51viidestsiljoonas	stsiljoonas
NUM_51viidestuhannes	stuhannes
NUM_51viidesundekiljardis	sundekiljardis
NUM_51viidesundekiljoonas	sundekiljoonas
NUM_51viidesviidettä	sviidettä
NUM_51viidesyhdeksättä	syhdeksättä
NUM_51viisibiljardia	sibiljardia
NUM_51viisibiljoonaa	sibiljoonaa
NUM_51viisidekiljardia	sidekiljardia
NUM_51viisidekiljoonaa	sidekiljoonaa
NUM_51viisiduodekiljardia	siduodekiljardia
NUM_51viisiduodekiljoonaa	siduodekiljoonaa
NUM_51viisikahdeksatta	sikahdeksatta
NUM_51viisikiljardia	sikiljardia
NUM_51viisikiljoonaa	sikiljoonaa
NUM_51viisikolmatta	sikolmatta
NUM_51viisikuudetta	sikuudetta
NUM_51viisikvadriljardia	sikvadriljardia
NUM_51viisikvadriljoonaa	sikvadriljoonaa
NUM_51viisikvintiljardia	sikvintiljardia
NUM_51viisikvintiljoonaa	sikvintiljoonaa
NUM_51viisikymmentä	sikymmentä
NUM_51viisimiljardia	similjardia
NUM_51viisimiljoonaa	similjoonaa
NUM_51viisineljättä	sineljättä
NUM_51viisinoniljardia	sinoniljardia
NUM_51viisinoniljoonaa	sinoniljoonaa
NUM_51viisioktiljardia	sioktiljardia
NUM_51viisioktiljoonaa	sioktiljoonaa
NUM_51viisipiljardia	sipiljardia
NUM_51viisipiljoonaa	sipiljoonaa
NUM_51viisisataa	sisataa
NUM_51viisiseitsemättä	siseitsemättä
NUM_51viisisentiljardia	sisentiljardia
NUM_51viisisentiljoonaa	sisentiljoonaa
NUM_51viisiseptiljardia	siseptiljardia
NUM_51viisiseptiljoonaa	siseptiljoonaa
NUM_51viisitoista	sitoista
NUM_51viisitredekiljardia	sitredekiljardia
NUM_51viisitredekiljoonaa	sitredekiljoonaa
NUM_51viisitriljardia	sitriljardia
NUM_51viisitriljoonaa	sitriljoonaa
NUM_51viisitsiljardia	sitsiljardia
NUM_51viisitsiljoonaa	sitsiljoonaa
NUM_51viisituhatta	situhatta
NUM_51viisiundekiljardia	siundekiljardia
NUM_51viisiundekiljoonaa	siundekiljoonaa
NUM_51viisiviidettä	siviidettä
NUM_51viisiyhdeksättä	siyhdeksättä
NUM_51yhdeksänbiljardia	änbiljardia
NUM_51yhdeksänbiljoonaa	änbiljoonaa
NUM_51yhdeksändekiljardia	ändekiljardia
NUM_51yhdeksändekiljoonaa	ändekiljoonaa
NUM_51yhdeksänduodekiljardia	änduodekiljardia
NUM_51yhdeksänduodekiljoonaa	änduodekiljoonaa
NUM_51yhdeksänkahdeksatta	änkahdeksatta
NUM_51yhdeksänkiljardia	änkiljardia
NUM_51yhdeksänkiljoonaa	änkiljoonaa
NUM_51yhdeksänkolmatta	änkolmatta
NUM_51yhdeksänkuudetta	änkuudetta
NUM_51yhdeksänkvadriljardia	änkvadriljardia
NUM_51yhdeksänkvadriljoonaa	änkvadriljoonaa
NUM_51yhdeksänkvintiljardia	änkvintiljardia
NUM_51yhdeksänkvintiljoonaa	änkvintiljoonaa
NUM_51yhdeksänkymmentä	änkymmentä
NUM_51yhdeksänmiljardia	änmiljardia
NUM_51yhdeksänmiljoonaa	änmiljoonaa
NUM_51yhdeksänneljättä	änneljättä
NUM_51yhdeksännoniljardia	ännoniljardia
NUM_51yhdeksännoniljoonaa	ännoniljoonaa
NUM_51yhdeksänoktiljardia	änoktiljardia
NUM_51yhdeksänoktiljoonaa	änoktiljoonaa
NUM_51yhdeksänpiljardia	änpiljardia
NUM_51yhdeksänpiljoonaa	änpiljoonaa
NUM_51yhdeksänsataa	änsataa
NUM_51yhdeksänseitsemättä	änseitsemättä
NUM_51yhdeksänsentiljardia	änsentiljardia
NUM_51yhdeksänsentiljoonaa	änsentiljoonaa
NUM_51yhdeksänseptiljardia	änseptiljardia
NUM_51yhdeksänseptiljoonaa	änseptiljoonaa
NUM_51yhdeksäntoista	äntoista
NUM_51yhdeksäntredekiljardia	äntredekiljardia
NUM_51yhdeksäntredekiljoonaa	äntredekiljoonaa
NUM_51yhdeksäntriljardia	äntriljardia
NUM_51yhdeksäntriljoonaa	äntriljoonaa
NUM_51yhdeksäntsiljardia	äntsiljardia
NUM_51yhdeksäntsiljoonaa	äntsiljoonaa
NUM_51yhdeksäntuhatta	äntuhatta
NUM_51yhdeksänundekiljardia	änundekiljardia
NUM_51yhdeksänundekiljoonaa	änundekiljoonaa
NUM_51yhdeksänviidettä	änviidettä
NUM_51yhdeksänyhdeksättä	änyhdeksättä
NUM_51yhdeksäsbiljardis	sbiljardis
NUM_51yhdeksäsbiljoonas	sbiljoonas
NUM_51yhdeksäsdekiljardis	sdekiljardis
NUM_51yhdeksäsdekiljoonas	sdekiljoonas
NUM_51yhdeksäsduodekiljardis	sduodekiljardis
NUM_51yhdeksäsduodekiljoonas	sduodekiljoonas
NUM_51yhdeksäskahdeksatta	skahdeksatta
NUM_51yhdeksäskiljardis	skiljardis
NUM_51yhdeksäskiljoonas	skiljoonas
NUM_51yhdeksäskolmatta	skolmatta
NUM_51yhdeksäskuudetta	skuudetta
NUM_51yhdeksäskvadriljardis	skvadriljardis
NUM_51yhdeksäskvadriljoonas	skvadriljoonas
NUM_51yhdeksäskvintiljardis	skvintiljardis
NUM_51yhdeksäskvintiljoonas	skvintiljoonas
NUM_51yhdeksäskymmenes	skymmenes
NUM_51yhdeksäsmiljardis	smiljardis
NUM_51yhdeksäsmiljoonas	smiljoonas
NUM_51yhdeksäsneljästtä	sneljästtä
NUM_51yhdeksäsnoniljardis	snoniljardis
NUM_51yhdeksäsnoniljoonas	snoniljoonas
NUM_51yhdeksäsoktiljardis	soktiljardis
NUM_51yhdeksäsoktiljoonas	soktiljoonas
NUM_51yhdeksäspiljardis	spiljardis
NUM_51yhdeksäspiljoonas	spiljoonas
NUM_51yhdeksässadas	ssadas
NUM_51yhdeksässeitsemättä	sseitsemättä
NUM_51yhdeksässentiljardis	ssentiljardis
NUM_51yhdeksässentiljoonas	ssentiljoonas
NUM_51yhdeksässeptiljardis	sseptiljardis
NUM_51yhdeksässeptiljoonas	sseptiljoonas
NUM_51yhdeksästoista	stoista
NUM_51yhdeksästredekiljardis	stredekiljardis
NUM_51yhdeksästredekiljoonas	stredekiljoonas
NUM_51yhdeksästriljardis	striljardis
NUM_51yhdeksästriljoonas	striljoonas
NUM_51yhdeksästsiljardis	stsiljardis
NUM_51yhdeksästsiljoonas	stsiljoonas
NUM_51yhdeksästuhannes	stuhannes
NUM_51yhdeksäsundekiljardis	sundekiljardis
NUM_51yhdeksäsundekiljoonas	sundekiljoonas
NUM_51yhdeksäsviidettä	sviidettä
NUM_51yhdeksäsyhdeksättä	syhdeksättä
NUM_51yhdeskahdeksatta	skahdeksatta
NUM_51yhdeskolmatta	skolmatta
NUM_51yhdeskuudetta	skuudetta
NUM_51yhdesneljästtä	sneljästtä
NUM_51yhdesseitsemättä	sseitsemättä
NUM_51yhdestoista	stoista
NUM_51yhdesviidettä	sviidettä
NUM_51yhdesyhdeksättä	syhdeksättä
NUM_51yksikahdeksatta	ksikahdeksatta
NUM_51yksikolmatta	ksikolmatta
NUM_51yksikuudetta	ksikuudetta
NUM_51yksineljättä	ksineljättä
NUM_51yksiseitsemättä	ksiseitsemättä
NUM_51yksitoista	ksitoista
NUM_51yksiviidettä	ksiviidettä
NUM_51yksiyhdeksättä	ksiyhdeksättä
NUM_ENSIMMÄINEN	nen
NUM_KAHDEKSAN	an
NUM_KAKSI	ksi
NUM_KOLMAS	s
NUM_KOLMASOSA	a
NUM_KOLME	e
NUM_KUUSI	si
NUM_KUUTISEN	
NUM_KYMMEN	
NUM_KYMMENEN	en
NUM_KYMMENKUNTA	a
NUM_KYMMENTÄ	
NUM_MILJARDI	i
NUM_MILJOONA	a
NUM_NELJÄ	ä
NUM_NELJÄS	s
NUM_PARI	i
NUM_PUOLI	i
NUM_SATA	ta
NUM_TOINEN	nen
NUM_TUHAT	t
NUM_VIISI	si
NUM_VIITISEN	
NUM_YHDEKSÄN	än
NUM_YKSI	ksi
PRON_AINOA	a
PRON_ERÄS	s
PRON_HÄN	
PRON_IKINEN	nen
PRON_ITSE	
PRON_JOKA	ka
PRON_JOKAINEN	nen
PRON_JOKIN	kin
PRON_JOKU	ku
PRON_JOMPIKUMPI	pikumpi
PRON_KAIKKI	ki
PRON_KOKO	
PRON_KUKA	uka
PRON_KUKAAN	ukaan
PRON_KUKAKIN	ukakin
PRON_KUKIN	ukin
PRON_KUMPI	pi
PRON_KUMPIKAAN	pikaan
PRON_KUMPIKIN	pikin
PRON_MÄÄ	
PRON_MÄ	ä
PRON_MA	
PRON_ME	
PRON_MIE	e
PRON_MIKÄÄN	kään
PRON_MIKÄ	kä
PRON_MIKÄKIN	käkin
PRON_MIKIN	kin
PRON_MINÄ	nä
PRON_MOLEMMAT	mat
PRON_MONES	s
PRON_MONI	i
PRON_MONIAS	s
PRON_MONTA	
PRON_MUU	u
PRON_MUUAN	n
PRON_MUUTAMA	a
PRON_NÄMÄ	mä
PRON_NE	e
PRON_NOI	
PRON_NUO	uo
PRON_SAMA	a
PRON_SE	e
PRON_TÄMÄ	mä
PRON_TOI	i
PRON_TOINEN	nen
PRON_TUO	uo
PRON_USEA	a
PRON_USEAMPI	pi
PRON_USEIMMAT	mmat
PRON_YKSI	ksi
